சீர்காழி => சீர்காழி
கோவிந்தராஜன் => கோவிந்தராஜன்
மகாலட்சுமி => மகாலட்சுமி
ஐயர் => ஐயர்
பி => பி
ஸ்ரீனிவாஸ் => ஸ்ரீனிவாஸ்
சோபனா => சோ
விக்னேஷ் => விக்னேஷ்
சிரேயா => சிரேய்
கோசல் => கோ
எஸ் => எஸ்
தட்சிணாமூர்த்தி => தட்சிணாமூர்த்தி
கார்த்திகேய => கார்த்தி
மூர்த்தி => மூர்த்தி
ஜானகி => ஜானகி
சுருதி => சுருதி
ஹாசன் => ஹாசன்
திலிப் => திலி
வர்மன் => வர்மன்
ஜெயச்சந்திரன் => ஜெயச்சந்திரன்
மலேசியா => மலேசி
வாசுதேவன் => வாசுதே
சுனந்தா => சுன
டி => டி
எம் => எம்
சௌந்தரராஜன் => சௌந்தரராஜன்
கே => கே
கலா => கலா
இராஜேஸ்வரி => இராஜேஸ்வரி
அனிருத் => அனிரு
ரவிச்சந்திரன் => ரவிச்சந்திரன்
ஜாலி => ஜாலி
ஆபிரகாம் => ஆபிர
ரெமோ => ரெமோ
பெர்னாண்டஸ் => பெர்னாண்டஸ்
மரண => மரண
கானா => கானா
விஜி => விஜி
கிடாக்குழி => கிடாக்குழி
மாரியம்மாள் => மாரியம்
கல்யாணி => கல்யாணி
நாயர் => நாயர்
உன்னிகிருஷ்ணன் => உன்னிகிருஷ்ணன்
கொல்லங்குடி => கொல்லங்குடி
கருப்பாயி => கருப்பாயி
இசையமைப்பாளர் => இசையமைப்பாளர்
யுவன் => யு
சங்கர் => சங்கர்
ராஜா => ராஜா
கிஷோர் => கிஷோர்
குமார் => கு
சி => சி
கிருஷ்ணன் => கிருஷ்ணன்
சாம் => சாம்
விசால் => வி
ரோஷினி => ரோஷினி
அஜீஸ் => அஜீஸ்
உண்ணிமேனன் => உண்ணிமே
ஹரிணி => ஹரிணி
சுதா => சுதா
ரகுநாதன் => ரகுநாதன்
அனுபமா => அனு
பிரம்மானந்தன் => பிரம்மானந்தன்
சுரேஷ் => சுரேஷ்
பீட்டர்ஸ் => பீட்டர்ஸ்
கல்பனா => கல்
ராகவேந்தர் => ராகவேந்தர்
பென்னி => பென்னி
தயாள் => தய்
ஜே => ஜே
ஜனனி => ஜனனி
சைந்தவி => சை
பவதாரிணி => பவதாரிணி
அரிஜித் => அரிஜி
சிங் => சிம்
மஹதி => மஹதி
மஞ்சரி => மஞ்சரி
முக்கேஷ் => முக்கேஷ்
சிறீமதுமிதா => சிறீமதுமி
ஜாவத் => ஜாவ
அலி => அலி
கைலாஷ் => கைலாஷ்
கேர் => கேர்
திருச்சி => திருச்சி
லோகநாதன் => லோகநாதன்
வேல்முருகன் => வேல்முருகன்
என் => என்
சுரேந்தர் => சுரேந்தர்
வி => வி
ரத்தினம் => ரத்தி
சிறுகளத்தூர் => சிறுகளத்தூர்
சாமா => சாமா
ராக்ஸ்டார் => ராக்ஸ்
இரமணி => இரமணி
அம்மாள் => மாள்
கிரிஷ் => கிரிஷ்
சபேஷ் => சபேஷ்
முரளி => முரளி
ஆலாப் => ஆலா
ராஜு => ராஜு
முகமது => முகம
ரபி => ரபி
சரண்யா => சரண்
சீனிவாசு => சீனிவாசு
தன்வி => தன்
ஷா => ஷா
ஜி => ஜி
வெங்கடேசு => வெங்கடேசு
யேசுதாஸ் => யேசுதாஸ்
ஹரிஷ் => ஹரிஷ்
ராகவேந்திரா => ராகவேந்திர்
சின்மயி => சின்மயி
சித் => சி
ஸ்ரீராம் => ஸ்
நிகில் => நி
மேத்யூ => மேத்யூ
ராஜேஷ் => ராஜேஷ்
மேகா => மேகா
நித்யஸ்ரீ => நித்யஸ்ரி
மகாதேவன் => மகாதே
அருண்ராஜா => அருண்ராஜ்
காமராஜ் => காமராஜ்
வெங்கட் => வெம்
பிரபு => பிரபு
மாலதி => மாலதி
லட்சுமணன் => லட்சுமணன்
பத்மலதா => பத்மல
ஹிப்ஹாப் => ஹிப்ஹ்
தமிழா => தமிழ்
ஹரிஹரன் => ஹரிஹரன்
தினா => தினா
சித்ரா => சி
ஹரிசரண் => ஹரிசரண்
ரவி => ரவி
அருண்மொழி => அருண்மொழி
வெங்கட்ராமன் => வெங்கட்ராமன்
விஜய் => விஜய்
ஆண்டனி => ஆண்டனி
பிரவீண் => பிரவீண்
மணி => மணி
ஜமுனா => ஜ
ராணி => ராணி
நாகூர் => நாகூர்
அனிபா => அனி
நேகா => நேகா
பாசின் => பா
தெ => தெ
இரா => இரா
மகாலிங்கம் => மகாலிங்கம்
ஆஷா => ஆஷா
போஸ்லே => போஸ்
ராகுல் => ராகுல்
நம்பியார் => நம்பி
மானசி => மானசி
எல் => எல்
மகராஜன் => மகராஜன்
அல்கா => அல்
அஜித் => அஜி
பாலாஜி => பாலாஜி
தரண் => தரண்
பிரகாஷ் => பிரகாஷ்
மகிழினி => மகிழினி
மணிமாறன் => மணிமாறன்
பாம்பே => பாம்
ஜெயஸ்ரீ => ஜெயஸ்ரி
பங்கஜ் => பங்கஜ்
முல்லிக் => முல்லி
கிட்டப்பா => கிட்ட
கமல்ஹாசன் => கமல்ஹாசன்
இலத்திகா => இலத்தி
சிறிலேகா => சிறிலே
பார்த்தசாரதி => பார்த்தசாரதி
வேணுகோபால் => வேணுகோ
சரண் => சரண்
சாதனா => சாதன்
சர்கம் => சர்கம்
மங்களம்பள்ளி => மங்களம்பள்ளி
பாலமுரளிகிருஷ்ணா => பாலமுரளிகிருஷ்
அறிவு => அறிவு
ஏ => ஏ
ஆர் => ஆர்
ரைஹானா => ரைஹ்
சூலமங்கலம் => சூலமங்கலம்
சகோதரிகள் => சகோதரி
கோமளா => கோமள்
பெங்களூர் => பெங்களூர்
இலதா => இலதா
இராசு => இராசு
பிரேம்ஜி => பிரேம்ஜி
அமரன் => அமரன்
இரசினிகாந்து => இரசினி
மனோ => மனோ
பிரசாந்தினி => பிரசாந்தினி
சுவர்ணலதா => சுவர்ணல
யுகேந்திரன் => யுகேந்திரன்
ரமணன் => ரமணன்
சாகுல் => சாகுல்
ஹமீது => ஹமீது
குலாம் => குல்
முஸ்தபா => முஸ்
கான் => கான்
விது => விது
பிரதாப் => பிர
சோனு => சோ
நிகம் => நிகம்
சின்னப்பொண்ணு => சின்னப்பொண்ணு
கானசரஸ்வதி => கானசரஸ்வதி
ரஞ்சித் => ரஞ்சி
கண்டசாலா => கண்ட
ஹனீஃபா => ஹனீஃ
மின்மினி => மின்மினி
சைலஜா => சைலஜ்
சௌம்யா => சௌம்
ராவ் => ரா
சுக்விந்தர் => சுக்விந்தர்
நடராஜன் => நடராஜன்
தீபன் => தீ
சக்ரவர்த்தி => சக்ரவர்த்தி
சானு => சானு
பாப் => பா
ஷாலினி => ஷாலினி
வைசாலி => வைசாலி
சமந்த் => சம
தீ => தீ
அனிதா => அனி
கார்த்திகேயன் => கார்த்திகேயன்
சித்தார்த் => சி
மேனன் => மே
விவேக் => விவே
மதுஸ்ரீ => மதுஸ்ரி
ஈஸ்வரி => ஈஸ்வரி
ராஜ்குமார் => ராஜ்
பாரதி => பாரதி
சுஜாதா => சுஜா
மோகன் => மோகன்
உதித் => உதி
நாராயண் => நாராயண்
கோவிந்த் => கோவி
வசந்தா => வச
சுவேதா => சுவே
ரூப் => ரூ
ரத்தோட் => ர
தீபா => தீபா
மிரியம் => மிரியம்
௭ஸ் => ௭ஸ்
சசிரேகா => சசிரே
ரீடா => ரீடா
தியாகராஜன் => தியாகராஜன்
மன்னா => மன்
தே => தே
தேவன் => தே
ஏகாம்பரம் => ஏகாம்பரம்
கார்த்திக் => கார்த்தி
சத்தியன் => சத்தியன்
இலா => இலா
அருண் => அருண்
வெங்கடேசன் => வெங்கடேசன்
பாலா => பாலா
செந்தில் => செ
கணேஷ் => கணேஷ்
ராகவன் => ராக
பித்துக்குளி => பித்துக்குளி
முருகதாஸ் => முருகதாஸ்
உதாஸ் => உதாஸ்
மால்குடி => மால்குடி
சுபா => சுபா
மது => மது
பாலகிருஷ்ணன் => பாலகிருஷ்ணன்
தேவ் => தே
பர்மன் => பர்மன்
நரேஷ் => நரேஷ்
மகேந்திர => மகேந்திர
கபூர் => கபூர்
ஜெயராமன் => ஜெயராமன்
சுர்முகி => சுர்முகி
ராமன் => ராமன்
வைக்கம் => வைக்கம்
சரஸ்வதி => சரஸ்வதி
பரவை => பரவை
முனியம்மா => முனியம்
ஸ்ரீகுமார் => ஸ்ரீகு
விக்ரம் => விக்ரம்
சுந்தர் => சுந்தர்
பாபு => பாபு
நடிகர் => நடிகர்
இளையராஜா => இளையராஜ்
மரியா => மரி
ரோ => ரோ
வின்சென்ட் => வின்சென்
அஸ்வத் => அஸ்வ
திருவுடையான் => திருவுடை
தனுஷ் => தனுஷ்
ஸ்ரீநிவாஸ் => ஸ்ரீநிவாஸ்
பாலசுப்பிரமணியம் => பாலசுப்பிரமணியம்
சத்யா => சத்
கிருஷ்ணராஜ் => கிருஷ்ணராஜ்
சுனிதா => சுனி
சாரதி => சாரதி
லக்சிமி => லக்சிமி
சிவனேஸ்வரலிங்கம் => சிவனேஸ்வரலிங்கம்
பிரியதர்ஷினி => பிரியதர்ஷினி
கிரேஸ் => கிரேஸ்
கருணாஸ் => கருணாஸ்
சாஷா => சாஷா
திருப்பதி => திருப்பதி
ராஜலட்சுமி => ராஜலட்சுமி
பகவதி => பகவதி
திப்பு => திப்பு
கிருஷ்ணசந்தர் => கிருஷ்ணசந்தர்
பாலக்காடு => பாலக்காடு
சிறீராம் => சி
தேனி => தேனி
குஞ்சரமாள் => குஞ்சரம்
ராஜேஸ்வரி => ராஜேஸ்வரி
ஏப்ரல் => ஏப்
புதன்கிழமை => புதன்கிழம்
சென்னையில் => சென்
கல்லீரல் => கல்
தொடர்பான => தொடர்
உடல்நலக் => உடல்நல
குறைவால் => குறை
காலமானார் => காலம்
இவருக்கு => இவர்
ஒரு => ஒரு
மகனும், => மகனும்,
மகளும் => ம
உள்ளனர் => உள்ள
மே => மே
அன்று => அன்று
சைதாப்பேட்டையில் => சைதாப்பேட்டை
உள்ள => உள்ள
அவரது => அவர
இல்லத்தில் => இல்லம்
தனது => தனது
அகவையில் => அகவை
பாலமுரளி => பாலமுரளி
கிருஷ்ணா => கிருஷ்
உடல் => உடல்
நலக்குறைவு => நலக்குறைவு
காரணமாக => காரணம்
நவம்பர் => நவம்
ஆம் => ஆம்
நாள் => நாள்
சென்னையிலுள்ள => சென்
இவர் => இவர்
மார்ச் => மார்
மதுரையில் => மதுரை
உடல்நலக்குறைவு => உடல்நலக்குறைவு
ஆகஸ்ட் => ஆகஸ்
வயதில் => வய
இறந்தார் => இற
இதயக் => இதய
கோளாறு => கோளாறு
சிகிச்சை => சிகி
பெற்று => பெற்று
வந்த => வ
நிலையில் => நிலை
தேதி => தேதி
மாலை => மாலை
மணிக்கு => மணி
அவர் => அவர்
ஆகத்து => ஆக
அன்று, => அன்று,
கோவிட்- => கோவிட்
தொற்று => தொற்று
இருப்பது => இரு
உறுதி => உறுதி
செய்யப்பட்டதை => செய்யப்பட்டதை
தொடர்ந்து, => தொடர்ந்து,
தனியார் => தனி
மருத்துவமனையில் => மருத்துவம
அனுமதிக்கப்பட்டார் => அனுமதி
சில => சில
நாட்களில் => நாள்
மோசமடைந்த => மோசமடை
உடல்நிலை, => உடல்நிலை,
பின்பு => பின்பு
கொஞ்சம் => கொஞ்சம்
கொஞ்சமாக => கொஞ்சம்
சகஜ => சகஜ
நிலைக்கு => நிலை
வந்தது => வ
வாய் => வாய்
வழியே => வழி
சாப்பிடும் => சாப்
அளவுக்கு => அள
இவருடைய => இவர்
உடல்நிலை => உடல்நில்
தேறியது => தேறி
ஆனால் => ஆன்
திடீரென்று => தி
செப்டம்பர் => செப்டம்
மீண்டும் => மீண்
மோசமடைந்ததை => மோசமடைந்ததை
மருத்துவர்கள் => மரு
தீவிர => தீவிர
அளித்தனர் => அளி
பலனளிக்காமல், => பலனளிக்காமல்,
உயிர் => உயிர்
மதியம் => மதியம்
பிரிந்தது => பிரி
மதிய => மதி
உணவை => உணவை
சாப்பிடும்போது => சாப்பிடும்போ
அவருக்கு => அவர்
மாரடைப்பு => மாரடைப்பு
ஏற்பட்டது => ஏற்
அடுத்த => அடு
தகனம் => தக
செய்யப்பட்டது => செய்
மனைவி => மனை
குழந்தைகள் => குழந்தை
சென்னை => சென்
வடபழனியில் => வடபழனி
அனுமதிக்கப்பட்டார், => அனுமதிக்கப்பட்டார்,
பலனின்றி => பலன்
அதிகாலை => அதிகால்
பிறகு => பிறகு
காவல்துறை => காவல்துறை
மரியாதையுடன் => மரியாதை
இறுதி => இறுதி
மரியாதை => மரியாதை
செலுத்தப்பட்டு, => செலுத்தப்பட்டு,
ஆண்டுகளாகப் => ஆண்டுகள்
பக்கவாத => பக்க
நோயால் => நோய்
பாதிக்கப்பட்ட => பாதி
பெப்ரவரி => பெப்ரவரி
ஞாயிற்றுக்கிழமை => ஞாயிற்றுக்கிழம்
பகல் => பகல்
தர்கா => தர்
மையவாடியில் => மையவாடி
நல்லடக்கம் => நல்லடக்கம்
செய்யப்பட்டுள்ளார் => செய்யப்பட்டுள்
நுரையீரல் => நுரை
பாதிப்பு => பாதிப்பு
அனுமதிக்கப்பட்டிருந்த => அனுமதிக்கப்பட்டிரு
சகோதரிகளில் => சகோதரி
இளையவரான => இளை
இல் => இல்
மூத்தவர் => மூ
ஜெயலட்சுமி => ஜெயலட்சுமி
சூன் => சூன்
சென்னை, => சென்னை,
பெசண்ட் => பெசண்
நகரில் => நகர்
இரவு => இரவு
சேலத்தில் => சேலம்
இருந்து => இரு
மகிழுந்தில் => மகிழு
ஊர் => ஊர்
திரும்பிக்கொண்டிருந்தபோது => திரும்பிக்கொண்டிருந்தபோ
நிகழ்ந்த => நிகழ்
நேர்ச்சியின் => நேர்ச்சி
உயிரிழந்தார் => உயிரிழ
அக்டோபர் => டோ
பீதாம்பரன் => பீதாம்பரன்
வசந்தகுமாரி => வசந்தகுமாரி
தம்பதியினருக்குப் => தம்பதியி
பிறந்தார் => பிற
கேரளாவின் => கேரள்
திரிச்சூரின் => திரிச்சூர்
இரிஞ்ஞாலகுடாவிலுள்ள => இரிஞ்ஞாலகு
ஓர் => ஓர்
இசைக் => இசை
குடும்பத்தைச் => கு்
சேர்ந்தவர் => சேர்
இவரது => இவர
தந்தையின் => தந்தை
மூத்த => மூ
சகோதரர் => சகோதரர்
கோபிநாதன் => கோபிநாதன்
கர்நாடக => கர்நாட
இசைக்கலைஞர் => இசைக்கலைஞர்
ஆவார் => ஆவ்
மேலும் => மேல்
இசையின் => இசை
ஆரம்பகால => ஆரம்பகால
வெளிப்பாடு => வெளிப்பாடு
மாமா => மாமா
மூலமாகவே => மூலம்
இருந்தது => இரு
சாதியை => சாதி
அகற்றுவதற்கான => அகற்றுவதல்
முயற்சியாக => முயற்சி
என்ற => என்ற
குடும்பப் => கு்
பெயரை => பெயர்
தாயின் => தாய்
பெயரான => பெயர்
என்பதை => என்பதை
எடுத்துக் => எடு
கொண்டு => கொண்டு
வசந்தாவாக => வச
மாறினார் => மாறி
இது => இது
தமிழ் => தமிழ்
தொலைக்காட்சி => தொலைக்காட்சி
சேனலில் => சேனல்
நிகழ்ச்சியில் => நிகழ்ச்சி
சேதுபதியால் => சேதுபதி
வெளிப்படுத்தப்பட்டது => வெளி
தந்தை => த
ஆண்டில் => ஆண்
கேரள => கேரள
அரசின் => அர
நீர்ப்பாசனத் => நீர்ப்பாச
துறையில் => துறை
பணிபுரிந்து => பணிபுரி
ஓய்வு => ஓய்வு
பெற்றதிலிருந்து => பெற்றதில்
தாணிக்குடம் => தாணிக்குடம்
பிரிட்ஜ் => பிரிட்ஜ்
இசைக்குழுவில் => இசைக்குழு
நட்சத்திர => நட்சத்திர
நடிகராக => நடிகர்
வருகிறார் => வரு
நீண்டகால => நீண்டகால
காதலியான => காதலி
இரஞ்சினி => இரஞ்சினி
அச்சுதன் => சுதன்
என்பவரை => என்ப
திசம்பர் => திசம்
திருமணம் => திருமணம்
செய்து => செய்
கொண்டார் => கொண்
மலையாள => மலையாள
நடிகை => நடிகை
ஐஸ்வர்யா => ஐஸ்
இலட்சுமி => இலட்சுமி
உறவினராவார் => உறவி
சிறு => சிறு
வயதிலிருந்தே => வயதிலிரு
தாயிடமும் => தாய்
சுந்தரேஸ்வர => சுந்தரேஸ்வர
பகவதரிடமும் => பகவதர்
இசை => இசை
கற்கத் => கற்க
தொடங்கினார் => தொடங்கி
இசைக்கருவிகள் => இசைக்கரு
மீது => மீது
மிகுந்த => மிகு
ஆர்வம் => ஆர்வம்
தெலுங்கு => தெலும்
மொழிகளில் => மொழி
பல => பல
திரைப்படப் => திரைப்பட
பாடல்கள் => பாடல்
பாடிய => பாடி
ஸ்வரர்ணவம் => ஸ்வரர்ணவம்
ரெக்கார்டிங் => ரெக்கார்டிம்
ஸ்டுடியோ => ஸ்டுடி
வைத்திருக்கும் => வைத்திர்
படங்களான => படங்கள்
மஹமேகா => மஹமே
பிரவுகல் => பிர
மெல்விலாசம் => மெல்விலாசம்
செரியானு => செரியானு
ஆகிய => ஆகி
இரு => இரு
படங்களுக்கு => படங்கள்
அமைத்துள்ளார் => அமைத்துள்
திருமணமான => திருமணம்
உடனேயே => உடனேய்
சென்றார் => செல்
தானாகவே => தானா
புல்லாங்குழல் => புல்லாங்குழ்
கற்றுக்கொண்டார் => கற்றுக்கொண்
திரையுலகில் => திரையுல
கலைஞராக => கலைஞர்
அறிமுகமானார் => அறிமுகம்
இவரின் => இவர்
பெற்றோர் => பெற்றோர்
புகழ்பெற்ற => புகழ்பெற்ற
தமிழ்த் => தமிழ்
திரைப்பட => திரைப்பட
பின்னணிப் => பின்னணி
பாடகர் => பாடகர்
ராஜலக்சுமி => ராஜலக்சுமி
ஆவர் => ஆவர்
வள்ளலார் => வள்ளல்
எனும் => என்
நாடகத்தில் => நாடகம்
முதன்முதலாகப் => முதன்முதல்
பாடினார் => பாடி
திருவருட்செல்வர் => திருவருட்செல்
திரைப்படத்தில் => திரைப்படம்
காதலாகிக் => கா
கசிந்து => கசி
பாடலை => பாடல்
பின்னணியில் => பின்னணி
ஐந்து => ஐந்
பூந்தமல்லி => பூந்தமல்லி
ஐ => ஐ
தேவாலயத்தில் => தேவாலயம்
பாடத் => பாட
தேவாலயத்திலும் => தேவாலயம்
கல்லூரியிலும் => கல்லூரி
தொடர்ந்து => தொடர்
கல்லூரியில் => கல்லூரி
நடந்த => நட
போட்டிக்கு => போட்டி
நடுவராக => நடு
வந்திருந்த => வந்திரு
கருணாசின் => கருண்
கவனத்தைக் => கவ
கவர்ந்தார் => கவர்
பின்னர் => பின்
இந்த => இ
இணையர் => இணையர்
கொண்டனர் => கொண்ட
நடித்த => நடி
வசூல்ராஜா => வசூல்ராஜ்
படத்தில் => படம்
பின்னணி => பின்னணி
பாடகராக => பாடகர்
அறிமுகமாகி => அறிமுகம்
சீனா => சீன்
தானா => தானா
டோய் => டோய்
இவரை => இவரை
படத்தின் => படம்
இயக்குநர் => இயக்குநர்
அமைப்பாளர் => அமைப்பாளர்
பரத்வாஜ் => பரத்வாஜ்
ஆகியோரிடம் => ஆகியோர்
பரிந்துரை => பரிந்துர்
செய்த => செய்
வாய்ப்பு => வாய்ப்பு
கிடைத்தது => கிடை
பாடல் => பா
வெற்றியாள் => வெற்றி
பிரபலமானார் => பிரபலம்
விரைவில் => விரை
தேவதையைக் => தேவதை
கண்டேன் => கண்
படத்திற்காக => படத்தில்
விளக்கு => விள
ஒண்ணு => ஒண்ணு
கற்க => கற்க
கசடற => கசடற
ஆலப்புழா => ஆலப்புழ்
அம்மணி => மணி
அல்லோ => அல்லோ
ஆறு => ஆறு
பிரியா => பிரி
விடு => விடு
மாமு => மாமு
சண்டை => சண்
வாடி => வாடி
கப்பக் => கப்ப
கிழங்கே => கிழங்கே
பாண்டி => பாண்டி
ஆடியடங்கும் => ஆடியடங்கும்
போன்ற => போன்ற
பிற => பிற
படங்களில் => படங்களில் 
வழக்கமாக => வழக்கம்
முக்கிய => முக்கி
கதாபாத்திரத்தில் => கதாபாத்திரம்
திரைப்படங்களில் => திரைப்படம்
படுவதுடன் => படு
பெரும்பாலும் => பெரும்
மேடை => மேடை
நிகழ்ச்சிகளிலும் => நிகழ்ச்சி
பாடிவந்தார் => பாடி
நடிகையாகவும் => நடிகை
பணியாற்றியுள்ளார் => பணியாற்றியுள்
குறிப்பாக => குறி
திருவிளையாடல் => திருவிளை
ஆரம்பம் => ஆரம்
கதகளி => கதகளி
துணை => துணை
வேடங்களில் => வேடம்
தோன்றினார் => தோன்றி
நடிகரும் => நடிகர்
அரசியல்வாதியுமான => அரசியல்வாதியும்
கருணாசை => கருணாசை
மணந்தார் => மண
அவரின் => அவர்
பாடகியாக => பாடகி
இணையரின் => இணையர்
மகனான => மகனா
கென் => கென்
அழகு => அழகு
குட்டி => குட்டி
செல்லம் => செல்லம்
நடித்துள்ளார் => நடித்துள்
ரகுமானுடன் => ர
இணைந்து => இணை
பாடல்களை => பாடல்
பாடியுள்ளார் => பாடியுள்
இதில் => இத்
சில்லுனு => சில்லுனு
காதல் => கா
ஸ்லம்டாக் => ஸ்லம்
மில்லியனர் => மில்லி
சமீபத்தில் => சமீ
தில்லி => தில்லி
படங்களின் => படங்
பாடல்களும் => பாடல்
அடங்கும் => அடங்
ஜெய் => ஜெய்
ஹோ => ஹோ
பாடலுக்கான => பாடல்
ஸ்பானிஷ் => ஸ்பானிஷ்
வரிகளை => வரி
எழுதினார் => எழுதி
ரஹ்மானுடனான => ரஹ்மானுடன்
வெற்றிக்குப் => வெற்றி
முன்னணி => முன்னணி
இசையமைப்பாளர்களிடமிருந்து => இசையமைப்பாளர்களிடம்
அழைப்புகள் => அழைப்பு
கிடைத்தன => கிடை
ஷங்கர் => ஷங்கர்
அமித் => அமி
திரிவேதி => திரிவேதி
இயக்குநர்களுக்காக => இயக்குநர்கள்
வது => வது
கிராமி => கிராமி
விருதுகளில் => விருது
ரஹ்மான் => ரஹ்
குல்சர் => குல்சர்
ஆகியோருடன் => ஆகியோர்
விஷுவல் => விஷு
மீடியாவிற்கு => மீடியாவி
எழுதிய => எழுதி
சிறந்த => சிற
விருதினைப் => விருதி
பகிர்ந்து => பகிர்
இடம் => இடம்
பெற்ற => பெற்ற
பாடலில் => பாடல்
எழுதியதற்காக => எழுதியதல்
இவ்விருது => விருது
பெற்றார் => பெ
விருது => விருது
தவிர => தவிர
லண்டனில் => லண்டன்
பிஎம்ஐ => பிஎம்ஐ
குல்சருடன் => குல்சர்
உலக => உலக
ஒலிப்பதிவு => ஒலிப்பதிவு
விருதினை => விருதி
ஜனவரி => ஜனவரி
மலேசியாவில் => மலேசி
நடைபெற்ற => நடைபெற்ற
லைவ் => லை
இன் => இன்
கான்செர்ட்டில் => கான்செர்டு
பங்கு => பங்
ஐஐஎம் => ஐஐஎம்
பெங்களூரில் => பெங்களூர்
கோக் => கோ
திரிவேதியுடன் => திரிவேதி
இந்தியாவில் => தியா
திரைப்படத் => திரைப்பட
பாடல்களைப் => பாடல்
பாடுவதன் => பாடுவதன்
மூலம் => மூலம்
சர்வதேச => சர்வதேச
நட்சத்திரமாக => நட்சத்திரம்
இருக்கிறார் => இர்
வயதிலேயே => வயதிலேய்
கற்ற => கற்ற
சுவிட்சர்லாந்து => சுவிட்சர்
சிங்கப்பூர் => சிங்கப்பூர்
இலங்கை => இலம்
நாடுகளுக்குச் => நாடுகள்
சென்று => ச்
நிகழ்ச்சிகளை => நிகழ்ச்சி
நடத்தினார் => நடத்தி
உழவன் => உழ
மகன் => மகன்
முதல் => மு
பாடலான => பாடல்
செந்தூரப் => செந்தூர
பூவேயில் => பூவேய்
ஆடுமேய்க்கும் => ஆடுமேய்
சிறுவனின் => சிறு
குரலில் => குரல்
பொள்ளாச்சி => பொள்ளாச்சி
சந்தையிலே => சந்தை
என்னும் => என்
பாடகராகினார் => பாடகராகி
பிரபல => பிரபல
இசையமைப்பாளர்களின் => இசையமைப்பாளர்
பாடல்களுக்குப் => பாடல்கள்
விஜய்யுடன் => விஜய்
அதிக => அதிக
மேகலா => மேகலா
இதயம் => இதயம்
நாடகங்களிலும் => நாடகம்
வாசுதேவனின் => வாசுதே
சகோதரி => சகோதரி
உள்ளார் => உள்
ஆம் => ஆம்
ஆண்டு => ஆண்டு
தொடங்கப்பட்ட => தொடம்
வானொலியான => வானொலி
சுவர்ண => சுவர்ண
ஒலியில் => ஒலி
பங்கேற்றபோது => பங்கேற்றபோ
தன் => தன்
வாழ்க்கைத்துணையான => வாழ்க்கைத்துணை
ஹேம => ஹேம
மாலினியைக் => மாலினி
கண்டார் => கண்
சிங்கப்பூரைச் => சிங்கப்பூர்
வானொலியில் => வானொலி
நடத்தி => நடத்தி
வந்தார் => வ
தென் => தென்
இந்திய => தி
நான் => நான்
அவனில்லை => அவன்
இயக்குனரான => இய
என்பவரால் => என்ப
அறிமுகப்படுத்தப்பட்டார் => அறிமு
ஹாரிஸ் => ஹாரிஸ்
ஜெயராஜ் => ஜெயராஜ்
தேவி => தேவி
ஸ்ரீ => ஸ்ரீ
பிரசாத் => பிர
இமான் => இம்
உள்ளிட்ட => உள்ளிட்ட
இயக்குனர்களுடன் => இய
பணிபுரிந்தார் => பணிபுரி
வெற்றி => வெற்றி
கண்ட => கண்ட
நரம்பியல் => நரம்
மொழி => மொழி
நிரலாக்க => நிரல்
நுட்பங்களை => நுட்பம்
கற்றுக்கொள்வதில் => கற்றுக்கொள்
ஆர்வத்தை => ஆர்வம்
வளர்த்துக் => வளர்
நிறுவனர்களான => நிறுவனர்கள்
ஜான் => ஜான்
கிரைண்டர் => கிரைண்டர்
ரிச்சர்ட் => ரிச்சர்
பேண்ட்லரிடமிருந்து => பேண்ட்லரிடம்
அதைப் => அதை
பற்றிக்கற்றுக் => க
கொள்ள => கொள்ள
ஆர்வத்தால் => ஆர்வம்
தனிப்பட்ட => தனி
பிரச்சினைகள் => பிரச்சி
சோர்வுகளை => சோர்வு
சமாளிக்க => சமாளி
மாதிரித் => மாதிரி
திட்டங்களை => திட்டம்
வழங்குவதற்கான => வழங்குவதல்
சிறப்பு => சிறப்பு
பள்ளிக்கூடம் => பள்ளிக்கூடம்
ஸ்கூல் => ஸ்கூல்
ஆப் => ஆப்
எக்ஸலன்ஸ் => ஸலன்ஸ்
நிறுவப்பட்டது => நிறு
தனி => தனி
நபர்களுக்கான => நபர்கள்
அமர்வுகள் => அமர்வு
வெளிப்படுத்திய => வெளிப்படுத்தி
பள்ளிக் => பள்ளி
சிறப்புத் => சிறப்பு
திறனாளர்களுக்காக => திறனாளர்கள்
இணை => இணை
நிறுவனருடன் => நிறு
சேர்ந்து => சேர்
நிகழ்வுகள் => நிகழ்வு
அமர்வுகளை => அமர்வு
நடத்தினர் => நடத்தி
கட்டத்தின்போது => கட்டத்தின்போ
மேகாவும் => மேகா
அவருடைய => அவர்
வணிகப் => வணிக
பங்குதாரரும் => பங்குதாரர்
தனிநபர் => தனிந
வளர்ச்சிக்காக => வளர்ச்சி
எக்ஸலன்ஸ் => எக்ஸலன்ஸ்
இன்ஸ்டாலேசன் => இன்ஸ்டாலேசன்
டெக்னாலஜி => டெக்னாலஜி
இ => இ
என்று => என்று
அழைக்கப்படும் => அழை
புதிய => புதி
தொழில்நுட்பத்தை => தொழில்நு
உருவாக்கி => உருவாக்கி
கண்டுபிடிப்புகளைத் => கண்டுபிடிப்பு
தொடங்கினர் => தொடங்கி
நாடு => நாடு
முழுவதும் => முழு
யைப் => யை
பயன்படுத்தி => பயன்படுத்தி
மாற்றத்தின் => மாற்றம்
வணிக => வணிக
சுகாதாரம் => சுகாதாரம்
மரபுரிமை => மரபுரிம்
முடுக்கம் => முடுக்கம்
சேவைகளை => சேவை
வழங்குவதற்கு => வழம்
நன்கு => நன்
பயிற்றுவிக்கப்பட்ட => பயிற்றுவி
நிபுணர்களின் => நிபுணர்
குழுவை => குழு
கர்னாடக => கர்னாட
பாபநாசம் => பாபநாசம்
சிவனின் => சி
கொள்ளுப் => கொள்ளு
பேத்தி => பேத்தி
பிறந்து => பிற
பெங்களூருக்கு => பெங்களூர்
மாறியவர் => மாறி
பள்ளிக்கல்வியினை => பள்ளிக்கல்வியி
முடித்தார் => முடி
வணிகவியலில் => வணிகவியல்
இளங்கலைப் => இளங்கல்
பட்டம் => பட்டம்
பாடுபவராக => பாடு
தொழில் => தொழ்
வாழ்க்கையை => வாழ்க்கை
ஆரம்பித்தார் => ஆரம்பி
சென்னையிலிருந்த => சென்னையிலிரு
ஆகஸ்டின் => ஆகஸ்
பால் => பால்
வழிகாட்டலின் => வழிகாட்டல்
கீழ் => கீழ்
மேற்கத்திய => மேற்கத்தி
இசையில் => இசை
வது => வது
நிலைவரை => நிலை
லண்டன் => லண்டன்
டிரினிடி => டிரினிடி
முடித்துள்ளார் => முடித்துள்
அமைப்பாளரான => அமைப்பாளர்
இம்மான் => மான்
மருதமலை => மருதமல்
அனிதாவை => அனி
அறிமுகப்படுத்தினார் => அறிமுகப்படுத்தி
இம்மானுடைய => மான்
அமைப்புகளில் => அமைப்பு
வகைகளை => வகை
ஆராய்வதற்கான => ஆராய்வதல்
அனிதாவிற்கு => அனிதாவி
ஐந்தாம் => ஐ
படை => படை
வரும் => வர்
ஷோக்கு => ஷோ
சுந்தரி => சுந்தரி
பாடலின் => பாடல்
மூலமாக => மூலம்
வட்டத்தில் => வட்டம்
நல்ல => நல்ல
அங்கீகாரம் => கீகாரம்
வாடா => வாடா
பையா => பையா
பெரிய => பெரி
பெற்றது => பெற்ற
வாகை => வாகை
சூட => சூட
வா => வா
செங்க => செம்
சூளகாரா => சூள
எனத் => என
தொடங்கும் => தொடம்
மற்றொரு => மற்றொரு
குறிப்பிடத்தக்கதாகும் => குறிப்பிட
தேசிய => தேசி
தேடித் => தேடி
தந்தது => த
இளையராஜாவின் => இளையராஜ்
தனிப்பாடல்களை => தனிப்பாடல்
பாடும் => பா
இரண்டிலும் => இரண்
வெளிவந்த => வெளி
ராமராஜ்ஜியத்தில் => ராமராஜ்ஜியம்
பாரம்பரிய => பாரம்பரி
சார்ந்த => சார்
காயம் => காயம்
மாசக்கணக்கா => மாசக்கணக்கா
செங்காத்து => செம்
பூமியிலே => பூமி
சிக்கிக்கிச்சு => சிக்கிக்கிச்சு
ஓரம்போ => ஓரம்போ
சூர்யகாந்தி => சூர்யகாந்தி
கன்னடம் => கன்னடம்
சொல்ப => சொல்
சவுண்டு => சவுண்டு
உருது => உருது
இந்தி => தி
மலாய் => மல்
வித்யாசாகர் => வித்யாசாகர்
மணிசர்மா => மணிசர்
ஸ்ரீகாந்த் => ஸ்ரீ
தேவா => தேவா
கோபால் => கோ
பலர் => பலர்
க்கும்மேற்பட்ட => மே
அமைப்பாளர்களிடம் => அமைப்பாளர்
பணிபுரிந்துள்ளார் => பணிபுரிந்துள்
மெல்லிசை => மெல்லிசை
நாட்டுப்புற => நாட்டுப்புற
கிளாசிக்கல் => கிளாசி
உட்பட => உட்பட
அனைத்து => அனை
வகைகளிலும் => வகை
யு => யு
இராணுவத்தில் => இராணுவம்
பணிபுரிந்ததால் => பணிபுரி
வட => வட
பள்ளிப்படிப்பை => பள்ளிப்படி
மேற்கொண்டார் => மேற்கொண்
என்பதால் => என்ப
இந்துஸ்தானி => துஸ்தானி
இசையைக் => இசை
கற்கும் => கல்
தற்போது => தற்போ
பின்னி => பின்னி
கிருஷ்ணகுமார் => கிருஷ்ணகு
என்பவர் => என்ப
ஆசிரியராக => ஆசிரியர்
தன்னுடன் => தன்
பிரதீப் => பிரதி
குமாரை => கு
வித்தியாசாகர் => வித்தியாசாகர்
சத்யம் => சத்யம்
கொச்சி => கொச்சி
ராஜாவு => ராஜாவு
படங்களிலும் => படங்
ஓசப்பச்சான் => ஓசப்பச்சான்
தஸ்கரவீரன் => தஸ்கரவீரன்
படத்திலும் => படம்
கனா => கனா
கண்டே => கண்
வில் => வில்
பிரபலமான => பிரபலம்
மூலை => மூலை
திருகும் => திர்
பாடல்களையிம் => பாடல்களையிம்
கருவறைப் => கருவறை
பூக்கள் => பூக்
திருநங்கைகள் => திருநங்கை
மக்கள் => மக்
பற்றியதிரைப்படம் => திரைப்படம்
சோகத்தை => சோகம்
சொல்லி => சொல்லி
அழ => அழ
பாடலையும் => பாடல்
ஆனந்தம் => ஆனந்தம்
ஆனந்தமே => ஆனந்தம்
பதிப்பான => பதி
சீதம்மா => சீதம்
வாகிட்லோ => வாகி
சிரிமல்லி => சிரிமல்லி
செட்டு => செட்டு
ஆறடுகுலு => ஆறடுகுலு
உண்டாடா => உண்டாடா
பாடலைப் => பாடல்
லேசா => லேசா
என்றத் => என்ற
திரைப்படத்தின் => திரைப்படம்
ஏதோ => ஏதோ
ஒன்று => ஒன்று
பாடலுக்காக => பாடல்
இயக்குனர் => இய
ஜயராஜுடன் => ஜயராஜ்
அறிமுகம் => அறிமுகம்
ஜங்ஷன் => ஜங்ஷன்
திரைப்படத்திற்கான => திரைப்படத்தில்
பூ => பூ
முகம் => முகம்
சிரிச்சா => சிரிச்சா
பாப் => பா
கார்ன் => கார்ன்
பாலசுப்பிரமணியத்துடன் => பாலசுப்பிரமணி
காதலாகி => காதலாகி
விசில் => வி
டோன்ட் => டோன்
வொரி => வொரி
ஹாப்பி => ஹாப்பி
சேனா => சேனா
படத்திற்காகசுத்தி => படத்திற்காகசுத்தி
சுத்தி => சுத்தி
வருவான் => வருவான்
சாமி => சாமி
கல்யாணம் => கல்யாணம்
தான் => தான்
கட்டிக்கிட்டு => கட்டிக்கிட்டு
தென்னவன் => தென்
வினோதனே => வினோதனே
குறும்பு => குறும்பு
இடம்பெற்ற => இடம்பெற்ற
வா => வா
மசக்காற்றே => மசக்காற்றே
திருடா => திரு
திருடி => திருடி
ஆயுர்வேத => ஆயுர்வே
அழகி => அழகி
திரையிசை => திரையிசை
வாழ்க்கையில் => வாழ்க்கை
சமீபத்திய => சமீபத்தி
பதிவுகளில் => பதிவு
திம்சு => திம்சு
கட்டை => கட்டை
திருமலை => திருமல்
சின்னா => ச்
வீடா => வீடா
கொக்கு => கொ
மீனத் => மீன
திங்குமா => திங்குமா
கோவில் => கோ
பச்சக்கிளி => பச்சக்கிளி
பச்சக்கிளி => பச்சக்கிளி
ஆகியவை => ஆகி
பாடல்களில் => பாடல்
மம்மி => மம்மி
செல்லமா => செல்லமா
ஜோர் => ஜோர்
பம்பர => பம்பர
கன்னு => கன்னு
மதுர => மதுர
வெச்சுக்க => வெ
வெச்சுக்க => வெ
வா => வா
கருடா => கரு
கருடா => கருடா
தவிலு => தவிலு
தவிலு => தவிலு
ஆகியவையும் => ஆகி
தொலைக்காட்சியின் => தொலைக்காட்சி
தர்மயுத்தம் => தர்மயுத்தம்
என்றத்தொலைக்காட்சித் => என்றத்தொலைக்காட்சி
தொடரில் => தொடர்
சிறீலேகா => சிறீலே
தமிழ்க் => தமிழ்
குடும்பத்தில் => கு்
தில்லியில் => தில்லி
வளர்ந்தார் => வளர்
புதுதில்லியின் => புதுதில்லி
மூத்தோர் => மூத்தோர்
மேல்நிலைப் => மேல்நில்
பள்ளியிலியிருந்து => பள்ளியிலி
பிறப்பால் => பிற
தென்னிந்தியரான => தென்னிந்தியர்
தென்னிந்திய => தென்னிந்தி
மொழிகளையும் => மொழி
இசையையும் => இசை
நான்காவது => நான்
புதுதில்லியில் => புதுதில்லி
ஆண்டுதோறும் => ஆண்டுதோ
நடைபெறும் => நடைபெ
அகில => அகில
போட்டியில் => போட்டி
பரிசு => பரிசு
வென்றார் => வெல்
கள் => கள்
களின்முற்பகுதி => முற்பகுதி
பாலிவுட்டின் => பாலிவுடு
மிக => மிக
முக்கியமான => முக்கியம்
பாடகர்களில் => பாடகர்
ஒருவராக => ஒரு
நாராயணன் => நாராயணன்
ஆனார் => ஆ
பல்வேறு => பல்வேறு
பாலிவுட் => பாலிவு
நட்சத்திரங்களுக்கு => நட்சத்திரங்கள்
திரையில் => திரை
நடிகர்களான => நடிகர்கள்
அமிதாப் => அமி
பச்சன் => பச்சன்
கன்னா => கன்
ஆனந்த் => ஆன
அமீர்கான் => அம்
ஷாருக் => ஷார்
சல்மான் => சல்
அக்‌ஷய் => ‌ஷய்
அஜய் => அஜய்
தேவ்கன் => தேவ்கன்
ஆகியோருக்காக => ஆகியோர்
டூயட் => டூய
பெரும்பாலானவை => பெரும்பால்
யாக்னிக் => யாக்னி
உடன் => உடன்
உள்ளன => உள்ள
ரேடியோ => ரேடி
நேபாளத்திற்காக => நேபாளத்தில்
மைதிலி => மைதிலி
பணியாளர் => பணியாளர்
வாழ்க்கையைத் => வாழ்க்கை
நேபாள => நேபாள
நம்பகத்தகுந்த => நம்பகத்தகு
மேற்கோள் => மேற்கோள்
நவீன => நவீன
நேபாளி => நேபாளி
எட்டு => எட்டு
ஆண்டுகளுக்குப் => ஆண்டுகள்
பாரதிய => பாரதி
வித்யா => வி
பவனில் => பவன்
இசையைப் => இசை
படிப்பதற்காக => படிப்பதல்
இந்தியத் => திய
தூதரகத்திலிருந்து => தூதரகத்தில்
நேபாளத்திற்கான => நேபாளத்தில்
உதவித்தொகைக்காக => உதவித்தொகை
மும்பைக்குச் => மும்பை
ரஞ்சனா => ரஞ்சன்
தெரிவித்தார் => தெரிவி
முதலில் => முதல்
மறுத்த => மறு
ஒத்துக்கொண்டு => ஒத்துக்கொண்டு
பராமரிப்புச் => பராமரிப்பு
செலவுகளை => செலவு
ஏற்றுக் => ஏ
ஒப்புக்கொண்டார் => ஒப்புக்கொண்
இருமுறை => இருமுறை
ஜா => ஜா
முதலாவதாகவும் => முதல்
இரண்டாவதாகவும் => இரண்
இல் => இ்
செய்த் => செய்
கொண்ட => கொண்ட
இந்தத் => இந்த
தம்பதிக்கு => தம்பதி
ஆதித்ய => ஆதி
இவரும் => இவர்
நேபாளத்தினைச் => நேபாளத்தி
சேர்ந்த => சேர்
ஹரேகிருஷ்ணா => ஹரேகிருஷ்
பிறந்த => பிற
தாய் => தாய்
புவனேஸ்வரி => புவனேஸ்வரி
ஆகியோருக்கு => ஆகியோர்
மகனாகப் => மகனா
இந்தியாவின் => தியா
குடியுரிமை => குடியுரிம்
விருதான => விரு
ரவமான => ரவமா
பத்மசிறீ => பத்மசிறி
விருதை => விருதை
வழங்கியபோது => வழங்கியபோ
நேபாளத்தில் => நேபாளம்
பிறந்ததாகக் => பிற
கூறி => கூறி
குடியுரிமையைப் => குடியுரிமை
பற்றிகேள்விகள் => கேள்
எழுந்தன => எழு
இருப்பினும் => இரு
நாராயணே => நாராயண்
அறிக்கைகளை => அறிக்கை
முற்றிலும் => மு
தவறானது => தவறானது
மறுத்தார் => மறு
பீகார் => பீ
மாநிலத்தின் => மாநிலம்
சுபால் => சு
மாவட்டத்தின் => மாவட்டம்
பைஸி => பைஸி
கிராமத்தில் => கிராமம்
தாய்வழி => தாய்வழி
தாத்தா => தா
பாட்டி => பாட்டி
வீட்டில் => வீடு
கூறினார் => கூறி
பத்மஸ்ரீவை => பத்மஸ்ரீ
ஏற்றுக்கொண்டது => ஏற்றுக்கொண்ட
விமர்சனத்திற்கு => விமர்சனத்தி
வழிவகுத்தபோது => வழிவகுத்தபோ
நாளிதழான => நாளிதழ்
காந்திபூரிடம் => காந்திபூர்
நேபாளத்தைச் => நேபாளம்
எனது => எனது
வீடு => வீடு
பீகாரில் => பீ
இருந்தது => இருந்தது
மதுரை => மதுர்
ஜில்லா => ஜில்லா
விடைகோடு => விடை
எங்கள் => கள்
கன்னத்தில் => கன்
முத்தமிட்டால் => முத்தமிடு
மல்லே => மல்
மல்லே => மல்லே
சாக்லேட் => சா
ஆஹா => ஆஹா
தமிழம்மா => தமிழம்மா
கண்களால் => கண்
கைது => கைது
செய் => செய்
பார்த்தாலே => ப்
பரவசம் => பரவசம்
பார்த்தாலே => பார்
பரவசம் => பரவசம்
பல்லேலக்கா => பல்லேல
சிவாஜி => சிவாஜி
தி => தி
பாஸ் => பாஸ்
கெடா => கெ
கரி => கரி
ராவணன் => ராவணன்
நான் => ந்
ஏன் => ஏன்
எம்டிவி => டிவி
சீசன் => சீசன்
என்னிலே => என்
மகா => மகா
ஒலியோ => ஒலியோ
கர்ம => கர்ம
வீரன் => வீரன்
கோச்சடையான் => கோச்சடை
புத்தம் => புத்தம்
புதிதாய் => புதிதாய்
கடைசி => கடைசி
பக்கம் => பக்கம்
வரவிருக்கும் => வரவிர்
படம் => படம்
சாரட்டு => சாரட்டு
வண்டியில => வண்டியில
காற்று => காற்று
வெளியிடை => வெளியிடை
மோரேத்துக்குச்சிந்தி => மோரேத்துக்குச்சிந்தி
செல்லியா => செல்லி
மச்சி => மச்சி
ஆடாத => ஆடாத
ஆட்டமெல்லாம் => ஆட்டம
பேசுவது => பேசு
கிளியா => கிளி
கடலகி => கடலகி
என்னை => என்
ஏதோ => ஏதோ
விட்டாய் => விடு
மஞ்சோட்டிலே => மஞ்சோடு
வசந்தத்தின் => வசந்தம்
கனல் => கனல்
வழிகளில் => வழி
புரியாத => புரி
புதிதாக => புதி
கடைசி => கடைசி
ஏண்டா => ஏண்
தலையில => தலையில
எண்ண => எண்ண
வெக்கல => வெக்கல
கச்சேரி => கச்சேரி
அவர்களால் => அவர்
அப்படத்தில் => படம்
கடவுளே => கடவுளே
ரஹ்மானின் => ரஹ்
காலேஜ் => காலேஜ்
மியூசிக்கில் => மியூசி
சமகால => சமகால
இசையை => இசை
பயிற்றுவிப்பாளராக => பயிற்றுவிப்பாளர்
அங்கே => கே
பணியாற்றிக் => பணியாற்றி
கொண்டிருக்கையிலேயே => கொண்டிருக்கையிலேய்
ரகுமான் => ர
திறமையைக் => திறமை
கண்டு => கண்டு
கடல் => கடல்
அடியே => அடியே
பாட => பாட
கொடுத்தார் => கொடு
தொழிலாக => தொழில்
கொள்ளுமாறு => கொள்ளுமாறு
தாயார் => தாய்
பரிந்துரைத்ததைத் => பரிந்துரைத்ததை
ஆல்பத்திற்கான => ஆல்பத்தில்
தாளங்களை => தாளம்
இசையமைக்கத் => இசையமை
அரவிந்தன் => அரவிந்தன்
தயாரிப்பாளர் => தயாரிப்பாளர்
சிவா => சிவா
யுவனின் => யு
இசைக்கோர்வைகளைக் => இசைக்கோர்
கேட்டபின் => கேட்ட
அப்படத்தின் => படம்
முன்னோட்டக் => முன்னோட்ட
காட்சிகளுக்காக => காட்சிகள்
இசையமைக்கச் => இசையமை
சொன்னார் => சொன்
அவ்விசையால் => விசை
ஈர்க்கப்பட்டு => ஈர்
முழு => முழு
பொறுப்பையும் => பொறு
யுவனுக்கு => யு
வழங்கினார் => வழங்கி
பெற்றோரிடமிருந்து => பெற்றோரிடம்
ஒப்புதல் => ஒப்பு
அப்பொறுப்பை => பொறு
ஏற்றுக்கொண்டார் => ஏற்றுக்கொண்
இவ்வாறு => வாறு
இசைப்பயணம் => இசைப்பயணம்
தொடங்கியது => தொடங்கி
படத்திற்கு => படத்தி
இசையமைக்கும்போது => இசையமைக்கும்போ
வயது => வயது
இன்றளவிலும் => இன்றள
அச்சிறுவயதில் => சிறு
இசையமைத்த => இசையமை
ஒரே => ஒரே
இசையமைக்க => இசையமை
முற்றிலும் => மு
தற்செயலானது => தற்செயல்
குறிப்பிட்டிருந்தார் => குறிப்பிட்டிரு
மக்களை => மக்
ஈர்க்கத் => ஈர்
தவறிவிட்டன => தவறிவிட்ட
இதனை => இதனை
வெளியான => வெளி
வேளை => வேளை
கல்யாண => கல்யாண
கலாட்டா => கலாடு
தோல்வியை => தோல்
சந்தித்தது => சந்தி
அப்படத்திற்கான => படத்தில்
இசையும் => இசை
பெருமளவில் => பெருமள
ஏற்கப்படவில்லை => ஏற்கப்பட
விமர்சகர் => விமர்சகர்
ஒருவர் => ஒரு
குறிப்பிடும் => குறி
இல்லை => இல்
என்றார் => எல்
படங்கள் => படங்
தோல்வியடைந்ததை => தோல்வியடைந்ததை
அடுத்து => அடு
யாரும் => யார்
பட => பட
வாய்ப்புகள் => வாய்ப்பு
கொடுக்கவில்லை => கொ
அச்சமயத்தில் => சமயம்
வசந்த் => வச
பூவெல்லாம் => பூவ
கேட்டுப்பார் => கேட்டு
யுவனை => யுவ
அனுகினார் => அனுகி
யுவனும் => யு
இசைக்காக => இசை
பாராட்டுகள் => பாராட்டு
குவிய => குவி
தொடிங்கின => தொடிங்கி
அதன் => அதன்
மாறுபட்ட => மாறு
புதுமையான => புதுமை
முயற்சி => முயற்சி
நியூ => நியூ
இந்தியன் => தியன்
எக்ஸ்பிரஸ் => ஸ்பிரஸ்
பாராட்டியது => பாராட்டி
பெயருக்கு => பெயர்
தகுதியுடையவர் => தகுதியுடை
குறிப்பிட்டு => குறிப்பிட்டு
மிகவும் => மிக
பாராட்டப்பட்ட => பாராட்ட
இரவா => இர
பகலா => பகலா
சுடிதார் => சுடி
அணிந்த்து => அணிந்த்து
இளைஞர்கள் => இளைஞர்
மத்தியில் => மத்தி
பிரபலப்படுத்தியது => பிரபலப்படுத்தி
இரண்டு => இரண்டு
உனக்காக => உன
எல்லாம் => எல்
ரிஷி => ரிஷி
பணியாற்றிய => பணியாற்றி
நடிப்பில் => நடி
இயக்கத்தில் => இயக்கம்
அதிரடி => அதிரடி
தீணாவில் => தீணா
பணியாற்றினார் => பணியாற்றி
தீணா => தீணா
படமாக => படமா
அமைந்தது => அமை
பார்வையாளர்களை => பார்வையாளர்
கவர்ந்தது => கவர்
வெற்றியில் => வெற்றி
இசைக்கு => இசை
பெரும் => பெர்
உண்டு => உண்டு
செல்வராகவனுடன் => செல்
துள்ளுவதோ => துள்ளு
இளமை => இளமை
இப்படத்தை => படம்
கஸ்தூரி => கஸ்தூரி
இயக்கினார் => இயக்கி
செல்வராகவன் => செல்
திரைக்கதை => திரைக்கதை
எழுதி => எழுதி
ராஜாவுடன் => ராஜா
இளமையின் => இளமை
இளையத்தலைமுறையினரை => இளையத்தலைமுறையி
வெகுவாக => வெகு
இப்படம் => படம்
செல்வராகவனின் => செல்
தம்பியும் => தம்
நடிகருமான => நடிகரும்
தனுஷின் => தனுஷ்
அறிமுகப்படமாகும் => அறிமுகப்படம்
வணிகரீதியாக => வணிகரீதி
குறிப்பிடத்தக்க => குறிப்பிட
வெற்றியடைந்தது => வெற்றியடை
பாலாவின் => பாலா
நந்தா => ந
திரைப்படத்திற்கு => திரைப்படத்தி
தொடங்கின => தொடங்கி
அதற்கு => அத
வருடம் => வருடம்
மாதத்தில் => மாதம்
இளைஞர்களை => இளைஞர்
ஈர்க்கும் => ஈர்
வகையில் => வகை
திரைப்படங்கள் => திரைப்படம்
சாம்ராஜ்யம் => சாம்ராஜ்யம்
திரைக்கு => திரை
வரவில்லை => வர
மட்டும் => மடு
வெளிவந்தது => வெளி
மௌனம் => மௌ
பேசியதே => பேசி
புன்னகை => புன்னகை
பூவே => பூவே
படத் => பட
இசைக்கலைஞரும் => இசைக்கலைஞர்
இசையமைப்பாளருமான => இசையமைப்பாளரும்
மூன்றாவது => மூல்
இளைய => இளை
பவதாரிணியின் => பவதாரிணி
தம்பி => தம்
ஒருமுறை => ஒருமுறை
தன்னை => தன்
விட => விட
திறமையானவர் => திறமை
ஒப்புக்கொண்டுள்ளார் => ஒப்புக்கொண்டுள்
தந்தையும் => த
உடன்பிறப்புகளும் => உடன்பிறப்பு
பாடியுள்ளனர் => பாடியுள்ள
இயக்குனரும் => இய
கங்கை => கங்
பாஸ்கர் => பாஸ்கர்
மாமாக்கள் => மாமா
பணியாற்றிவரும் => பணியாற்றி
பார்த்தி => பார்த்தி
ஆகியோர் => ஆகியோர்
உறவினர்கள் => உறவி
செயின்ட் => செய்
பீட்ஸ் => பீட்ஸ்
ஆங்கிலோ => ஆங்
மேல்நிலைப்பள்ளியில் => மேல்நிலைப்பள்ளி
படித்தார் => படி
பத்தாம் => ப
வகுப்பு => வகுப்பு
வரை => வரை
மற்றுமே => ம
பயின்ற => பயின்ற
ஜேக்கப் => ஜே
மாஸ்டரிடமிருந்து => மாஸ்டரிடம்
இங்கிலாந்தின் => கிலா
டிரினிட்டி => டிரினிட்டி
கல்லூரியுடன் => கல்லூரி
இணைந்த => இணை
மியூசி => மியூசி
மியூசிகல் => மியூசிகல்
பியானோ => பி
வகுப்புகளில் => வகுப்பு
கலந்துக்கொண்டார் => கலந்துக்கொண்
எப்போதும் => போ
விமானி => விமானி
ஆகவும் => ஆக
உலகம் => உலகம்
பயணிக்க => பயணி
விரும்புவதாகவும் => விரும்பு
சுற்றியுள்ள => சுற்றி
இசையுடன் => இசை
வளர்ந்ததால் => வளர்
​​இறுதியில் => ​​இறுதி
இசைக்கலைஞரானார் => இசைக்கலைஞர்
பிப்ரவரியில் => பிப்ரவரி
இஸ்லாம் => இஸ்
மதத்தை => மதம்
ஏற்றுக்கொண்டு => ஏற்றுக்கொண்டு
விட்டதாக => விட்ட
டிவிட்டர் => டிவிட்டர்
கணக்கில் => கண
தன்னுடைய => தன்
முஸ்லிம் => முஸ்லிம்
பெயர் => பெயர்
அப்துல் => துல்
ஹாலிக் => ஹாலி
என்பதாகவும் => என்ப
ஜஃப்ரூன் => ஜஃப்ரூன்
நிஷா => நிஷா
பெண்ணை => பெண்
இஸ்லாமிய => இஸ்லாமி
முறைப்படி => முறை
செய்துக்கொண்டார் => செய்துக்கொண்
இவர்களுக்கு => இவர்கள்
ஆன்று => ஆன்று
ஆண் => ஆண்
குழந்தை => குழ
பிறந்தது => பிற
சசியின் => சசி
அபிநந்தம் => அபிநந்தம்
என்றப் => என்ற
கண்ணூர் => கண்ணூர்
ராஜன் => ராஜன்
புஷ்பதல்பதின் => புஷ்பதல்
யேசுதாசுடன் => யேசு
சமந்தின் => சம
ஐகா => ஐகா
தாஜிபா => தாஜி
இந்தியா => தியா
பரபரப்பை => பரபர
ஏற்படுத்தியது => ஏற்படுத்தி
லகான் => லக்
தால் => தால்
இசையமைப்பாளர்களுக்காக => இசையமைப்பாளர்கள்
விஜு => விஜு
தபூ => தபூ
மாலிக் => மாலி
இயக்குனர்களுக்காகவும் => இயக்குனர்கள்
லாலு => லாலு
யாதவ் => யாத
கேர்ல்பிரெண்ட் => கேர்ல்பிரெண்
எயிட் => எயி
மலமால் => மலம்
வீக்லி => வீக்லி
துஜே => துஜே
மேரி => மேரி
கசம் => கசம்
சேத்னா => சே
தில் => தில்
ஜோ => ஜோ
பீ => பீ
கஹே => கஹே
டிராஃபிக் => டிராஃ
சிக்னல் => சி
கஹூன் => கஹூன்
பியார் => பி
ஹைசாம்கு => ஹை
மிர்ச் => மிர்
போன்றத் => போன்ற
பாடல்களுக்காகவும் => பாடல்கள்
சல்கா => சல்
ரே => ரே
பிரபலமானது => பிரபலம்
சிங்கப்பூரின் => சிங்கப்பூர்
ஆசியா => ஆசி
விருதுகளை => விருது
வென்றுள்ளார் => வென்றுள்
கைஸ் => கைஸ்
ஹை => ஹை
மஜா => மஜா
நாவ் => நா
கிரண் => கிரண்
குல்கர்னி => குல்கர்னி
இசைத் => இசை
தொகுப்பின் => தொகு
பகுதியாகவும் => பகுதி
இருந்தார் => இரு
இல் => இ்
சுபாஷ் => சுபாஷ்
கோர்படேவின் => கோர்படே
கர்ப் => கர்
லேகர் => லேகர்
இயக்கிய => இயக்கி
மராத்தி => மராத்தி
நாடக => நாடக
திரைப்படமான => திரைப்படம்
சாந்த் => சா
பிரிதிச்சா => பிரிதி
ஆகியவற்றுடன் => ஆகி
தொடர்புடையவர் => தொடர்புடை
திரைப்படங்களுக்கு => திரைப்படங்கள்
பாடுவதைத் => பாடுவதை
தொகுப்பிலும் => தொகு
பணியாற்றி => பணியாற்றி
குங்குனி => குங்குனி
தூப் => தூ
யூடியூப்பில் => யூடியூ
காணொளிக் => காணொளி
காட்சியாக => காட்சி
வெளியிட்டுள்ளார் => வெளியிட்டுள்
ஆவது => ஆவ
கடலூரில் => கடலூர்
கலந்துகொண்டு => கலந்துகொண்டு
ஆண்டுகளாக => ஆண்டுகள்
இணைவு => இணைவு
பஜனை => பஜனை
பக்தி => பக்தி
ஆகியவற்றின் => ஆகி
நிகழ்ச்சிகளில் => நிகழ்ச்சி
நிகழ்த்தியுள்ளார் => நிகழ்த்தியுள்
க்கும்விசைப்பலகை => விசைப்பலகை
நிகழ்ச்சிகளையும் => நிகழ்ச்சி
வழங்கியுள்ளார் => வழங்கியுள்
ஆவது => ஆவது
வார => வார
இதழான => இதழா
ஆனந்த => ஆன
விகடன் => விகடன்
சாதனை => சாத
நாயகி => நாயகி
அங்கீகரித்தது => கீகரி
தினமணி => தினமணி
ஏழு => ஏழு
இசைக்குயில் => இசைக்குயில்
கவிஞரும் => கவிஞர்
பாடலாசிரியருமான => பாடலாசிரியரும்
வைரமுத்து => வைரமு
குமுதத்திற்கு => குமுதத்தி
அளித்த => அளி
பேட்டியில் => பேட்டி
நீ => நீ
மகள் => மகள்
தலைப்பில் => தலை
குறிப்பிட்டார் => குறிப்பிடு
பாலக்காட்டில் => பாலக்காடு
சேருக்குட்டி => சேருக்குட்டி
ஆகியோருக்குப் => ஆகியோர்
ஆர்மோனியக் => ஆர்மோனி
கலைஞரும் => கலைஞர்
பாடகரும் => பாடகர்
ஆர்மோனியம் => ஆர்மோனியம்
ஆகியவற்றில் => ஆகி
சிறந்து => சிற
விளங்கினார் => விளங்கி
சுவர்ணலதாவின் => சுவர்ணல
குடும்பத்தினர் => குடும்பத்தி
கர்நாடகாவில் => கர்நாட
சிமோகா => சிமோ
நகருக்குக் => நகர்
குடி => குடி
பெயர்ந்தனர் => பெயர்
அங்கேயே => கேயே
உயர் => உயர்
கல்வியையும் => கல்
கற்றார் => க
இளையராஜாவுக்காக => இளையராஜ்
குறிப்பிடப்பட்ட => குறிப்பிட
சேர்க்கைகளில் => சேர்க்கை
ஒன்றாக => ஒல்
குறிக்கப்பட்டார் => குறி
சின்னதம்பி => சின்னதம்
போவோமா => போ
ஊர்கோலம் => ஊர்கோலம்
நீ => நீ
எங்கே => கே
அன்பே => அன்
பெற்றன => பெற்ற
பாடலுக்கு => பாடல்
தமிழக => தமிழ
அரசு => அரசு
வழங்கி => வழங்கி
கௌரவித்தது => கௌரவி
தளபதி => தளபதி
ராக்கம்மா => ராக்கம்
கையத்தட்டு => கையத்தட்டு
பிபிசி => பிபிசி
பாடல்களால் => பாடல்
ஆன => ஆன
வெற்றிப்பாடலாக => வெற்றிப்பாடல்
பட்டியலில் => பட்டியல்
சொல்லிவிடு => சொல்லி
வெள்ளிநிலவே => வெள்ளிநிலவே
கண்ணே => கண்
கதை => கதை
என்னைத் => என்
தொட்டு => தொட்டு
அள்ளிகொண்ட => அள்ளிகொண்ட
சோதனை => சோத
ஸ்வர்ணலதா => ஸ்வர்ணல
கூட்டணி => கூட்டணி
ஆண்டிலிருந்து => ஆண்டில்
அவற்றின் => அவ
சேர்க்கை => சேர்
முக்கலா => ம்
முக்கபாலா => முக்கபாலா
ஹை => ஹை
ராமா => ராமா
யே => யே
க்யா => க்யா
ஹுவா => ஹுவா
மந்திர => மந்திர
பாடல்களுக்காக => பாடல்கள்
அறியப்படுகிறது => அறி
அவை => அவை
கருத்தம்மாவின் => கருத்தம்
போராளே => போர்
பொன்னுதாயி => பொன்னுதாயி
ரகுமானின் => ர
விருதைப் => விருதை
பெண் => பெண்
பாடகி => பாடகி
ரகுமானுக்காக => ர
கிட்டத்தட்ட => கிட்டத்தட்ட
கேரளத்தைப் => கேரளம்
பிறப்பிடமாகக் => பிறப்பிடம்
மலேசியாவைச் => மலேசி
சத்து => சத்
அம்மாளு => மாளு
தம்பதியருக்கு => தம்பதியர்
எட்டாவது => எடு
தமிழர் => தமிழர்
குழு => குழு
ஒன்றில் => ஒல்
நாடகங்களில் => நாடகம்
அனுபவத்தை => அனுபவம்
நம்பிக்கையாகக் => நம்பிக்கை
வாய்ப்புகளைத் => வாய்ப்பு
தேடினார் => தேடி
மலேசியத் => மலேசி
தமிழர்கள் => தமிழர்
கூட்டாகத் => கூடு
தயாரித்த => தயாரி
இரத்தப் => இர
பேய் => பேய்
தமிழ்ப் => தமிழ்
முறையாக => முறை
நடிகனாக => நடிகன்
களில்விளம்பர => விளம்பர
நிறுவனங்களுக்காக => நிறுவனங்கள்
ஆவணப் => ஆவண
பாவலர் => பாவலர்
பிரதர்ஸ் => பிரதர்ஸ்
குழுவில் => குழு
மேடைக் => மேடை
கச்சேரிகளில் => கச்சேரி
பாடி => பாடி
தமிழ்நாட்டில் => தமிழ்நாடு
ஆரம்பகாலத்தில் => ஆரம்பகாலம்
இசையினைப் => இசையி
பயின்றார் => பயில்
லலிதா => லலி
விரிவுரையாளரும் => விரிவுரையாளர்
நாளேட்டில் => நாளேடு
ரீடாஇந்துஸ்தானி => ரீடாஇந்துஸ்தானி
ஆசிரியர்களிடம் => ஆசிரியர்
பயிற்சி => பயிற்சி
பயிற்சியாளர் => பயிற்சியாளர்
வடிவமைப்பு => வடிவமைப்பு
ஆலோசனை => ஆலோச
வர்த்தக => வர்
நிறுவனத்தை => நிறு
நிர்வகிக்கிறார் => நிர்வகி
மைலாப்பூரில் => மைலாப்பூர்
சீனியர் => சீனியர்
நிலைப் => நிலை
பள்ளியில் => பள்ளி
ஆரம்பக் => ஆரம்
கல்வியைக் => கல்
ஸ்டெல்லா => ஸ்டெல்
மாரிஸ் => மாரிஸ்
வடிவமைப்பில் => வடிவமை
இளங்கலை => இளங்கல்
படிப்பை => படி
முடித்துவிட்டு => முடி
தாயையும் => தாயை
சகோதரியையும் => சகோதரி
பின்பற்றிச் => பின்
இருந்த => இரு
மற்ற => மற்ற
இசைபாணிகளின் => இசைபாணி
மேல் => மேல்
நாட்டம் => நாட்டம்
அதைக் => அதை
கண்டறிந்து => கண்டறி
ரீதியிலும் => ரீதி
பாணியிலும் => பாணி
அதை => அதை
பரிசோதித்தார் => பரிசோதி
கணிணி => கணிணி
வரைகலைஞர் => வரைகலைஞர்
விஷுலைசர் => விஷுலைசர்
உத்தோபிக் => தோபி
ஒருங்கிணைந்த => ஒருங்கிண்
அரங்கத்தின் => அரங்கம்
நிறுவனர் => நிறு
தமிழில் => தமிழ்
பாடுவதற்கு => பாடு
முன் => முன்
ஆவணப்படத்திற்காக => ஆவணப்படத்தில்
பாடல்களையும் => பாடல்
ஸ்லோகங்களையும் => ஸ்லோகம்
மலையாளத் => மலையாள
வெற்றிப் => வெற்றி
காரணங்களால் => காரணம்
வருடங்களாக => வருடங்கள்
அவரால் => அவர்
முடியவில்லை => முடி
சத்யன் => சத்யன்
அந்திக்காடு => திக்காடு
அச்சுவின்டே => சு
அம்மா => மா
மலையளப் => மலையள
உலகிற்கு => உல
தனித்து => தனி
இரமேஷ் => இரமேஷ்
இராதாகிருஷ்ணன் => இராதாகிருஷ்ணன்
கைதாபிரம் => கைதாபிரம்
விசுவநாதன் => விசுவநாதன்
ஜெயசந்திரன் => ஜெயசந்திரன்
மறைந்த => மறை
ரவீந்திரன் => ரவீந்திரன்
இசையமைப்பாளர்களுடன் => இசையமைப்பாளர்
பாலபாஸ்கரின் => பாலபாஸ்கர்
மழயில் => மழய்
ஆரோ => ஆரோ
ஓரல் => ஓரல்
தொகுப்புகளுக்கும் => தொகுப்பு
க்கும்சூர்யா => சூர்யா
பதாகையின் => பதாகை
இந்தியாவிலும் => தியா
உலகிலும் => உல
கசல் => கசல்
வும் => வும்
புகழ் => புகழ்
மீடியா => மீடி
ஒன் => ஒன்
தொலைக்காட்சியில் => தொலைக்காட்சி
கயல் => கயல்
பிரத்யேக => பிரத்யே
நிகழ்ச்சியை => நிகழ்ச்சி
நிகழ்த்தினார் => நிகழ்த்தி
ஆம் => ஆம்
பாடகருக்கான => பாடகர்
முறை => முறை
பெற்றுள்ளார் => பெற்றுள்
ஏசியானெட் => ஏசியானெ
விருதையும் => விருதை
கிரானா => கிர்
கரானாவின் => கர்
பண்டிட் => பண்டி
இரமேசு => இரமேசு
ஜூலேவின் => ஜூலே
படிப்பைத் => படி
தொடர்கிறார் => தொடர்
தமிழ்நாட்டின் => தமிழ்நாடு
தஞ்சாவூரில் => தஞ்சாவூர்
சேவியர் => சேவியர்
சகாயராஜ் => சகாயராஜ்
சோபியா => சோபி
சிஃப்ரா => சிஃ
தங்கையும் => தங்
எங்கும் => கும்
கற்கவில்லை => கற்க
எந்த => எ
இசைப் => இசை
பின்னணியும் => பின்னணி
இல்லாத => இல்
குடும்பத்திலிருந்து => குடும்பத்தில்
வந்தவர் => வ
இலயோலாக் => இலயோ்
ஆங்கில => ஆங்கில
இலக்கியத்தில் => இலக்கியம்
கல்லூரி => கல்லூரி
நண்பர்களுடன் => நண்
இசைக்குழுவைத் => இசைக்குழு
தொடங்கி => தொடங்கி
போட்டிகளில் => போட்டி
பங்கேற்றுள்ளார் => பங்கேற்றுள்
இயல்பான => இயல்
பெற்றோர்களான => பெற்றோர்கள்
இராசுவும் => இராசு
ராசுவும் => ராசு
பாடகர்களாக => பாடகர்கள்
அதே => அதே
நேரத்தில் => நேரம்
சாந்தா => சா
கை => கை
பத்மநாபன் => பத்ம
களில்அறியப்பட்ட => அறி
பெயர்கள் => பெயர்
பள்ளி => பள்ளி
தொழில்முறை => தொழில்முறை
துடுப்பாட்ட => துடுப்பாட்ட
வீரராகி => வீரர்
அளவில் => அள
இந்தியாவை => தியா
பிரதிநிதித்துவப்படுத்த => பிரதிநிதி
விரும்பினாலும் => விரும்
சென்னையில்ல் => சென்
பட்டப்படிப்பு => பட்டப்படிப்பு
வேறு => வேறு
திட்டங்கள் => திட்டம்
இருந்தன => இரு
கல்லூரித் => கல்லூரி
தோழர்கள் => தோழர்
இணையாக => இணை
கித்தார் => கி
ஊக்கமளித்தனர் => ஊக்கமளி
மாத => மாத
வாசிப்பதிலும் => வாசி
பாடுவதிலும் => பாடு
சுயமாக => சுயம்
இசைக்கலைஞராக்கியது => இசைக்கலைஞராக்கி
மதிப்புமிக்க => மதிப்புமி
கலாச்சார => கலாச்சார
பரவியது => பரவி
தொழில்நுட்ப => தொழில்நு
நிறுவனம் => நிறு
நடத்திய => நடத்தி
சாரங் => சாரம்
நிகழ்ச்சி => நிகழ்ச்சி
வாசிப்பிற்கு => வாசிப்பி
கருவியாக => கருவி
வெளிநாட்டிலும் => வெளிநாடு
ஏராளமான => ஏராளம்
பதிவு => பதிவு
நேரடி => நேரடி
நிகழ்ச்சிகளின் => நிகழ்ச்சி
தொடக்க => தொட
புள்ளியாக => புள்ளி
அது => அது
என்னமோ => என்
ஏதோ => ஏதோ
இல் => இ்
எங்கேயும் => கேய்
காதல் => காதல்
முக்கியத்துவம் => முக்கியத்துவம்
அளித்தன => அளி
இப்போது => போது
அரங்கங்களிலும் => அரங்கம்
பாடுவதும் => பாடு
இசைப்பதுவுமாக => இசைப்பதுவும்
யுவ் => யு
என்றை => எல்
மலையாளப் => மலையாள
நெஞ்சோடு => நெஞ்
சேர்த்து => சேர்
உடனடி => உடனடி
வெற்றியைப் => வெற்றி
மாதங்களில் => மாதம்
மில்லியன் => மில்லியன்
பார்வையாளர்களைத் => பார்வையாளர்
தாண்டியது => தாண்டி
பிரபாவை => பிர
அவர்களது => அவர்கள
பிப்ரவரி => பிப்ரவரி
நடந்தது => நட
வினோத் => வினோ
விஷால் => விஷ்
மூன்று => மூன்று
மகன்கள் => மகன்
இவர்களது => இவர்கள
இரண்டாவது => இரண்
ஆண்டுகளில் => ஆண்டு
மாநில => மாநில
வென்ற => வென்ற
நாராயண => நாராயண
குருவின் => குரு
செய்தி => செய்தி
ஒரே => ஒரே
மதம் => மதம்
மனிதர்களுக்கும் => மனிதர்
கடவுள் => கடவுள்
இளம் => இளம்
சக => சக
மனிதர்களுடன் => மனிதர்
பழகுவதில் => பழகு
தாக்கத்தை => தாக்கம்
இசைக்கலைஞர்களிடமும் => இசைக்கலைஞர்
சொந்த => சொ
ஹீரோக்களைக் => ஹீரோ
கொண்டிருந்தார் => கொண்டிரு
ரஃபி => ரஃபி
செம்பை => செம்
மருத்துவநாத => மரு
பகவதர் => பகவதர்
போற்றுகிறார்கள் => போற்று
வருகை => வருகை
வருகிறது => வரு
கொல்லூர் => கொல்லூர்
மூகாம்பிகை => மூகாம்பிகை
கர்நாடகா => கர்நாட
keerthans => keerthans
கலைகளின் => கலை
தெய்வம் => தெய்வம்
பிறந்தநாளில் => பிற
விழா => விழா
ஒன்பது => ஒன்ப
ஒவ்வொரு => ஒவ்வொரு
ஜனவரியிலும் => ஜனவரி
முகம்பிகா => முகம்
கோவிலில் => கோவில்
தொடங்குகிறது => தொடம்
பிறந்தநாளை => பிற
சப்ததி => சப்ததி
சங்கீதர்ச்சனா => சங்கீதர்ச்சன்
பாடகர்களுடன் => பாடகர்
தெய்வத்திற்கு => தெய்வத்தி
கொண்டாடினார் => கொண்டாடி
தியாகராஜாவின் => தியாகராஜ்
கவிதைகளில் => கவிதை
பஞ்சரத்ன => பஞ்சர
கயானா => கயானா
சங்கீதர்ச்சனத்தில் => சங்கீதர்ச்ச
வித்யாரம்பா => வித்யாரம்
விழாவிலும் => விழா
பங்கேற்றார் => பங்கே
வானொலி => வானொலி
சங்கீதர்ச்சனாவை => சங்கீதர்ச்சன்
கேரளா => கேரள்
ஒளிபரப்பியது => ஒளிபர
ஹரிவராசனம் => ஹரிவராசனம்
ஹிட் => ஹி
அய்யப்பாவுக்கு => ய
அர்ப்பணித்த => அர்ப்பணி
யேசுதாஸில் => யேசுதாஸ்
மராட் => மரா
படுகொலையின் => படுகொலை
போது => போது
கவிஞர் => கவிஞர்
சுகதகுமாரியுடன் => சுகதகுமாரி
அந்த => அ
இடத்திற்குச் => இடத்தி
வன்முறைக்கு => வன்முறை
எதிராக => எதிர்
வகுப்புகளை => வகுப்பு
தேவராஜன் => தேவராஜன்
வடிவமான => வடிவம்
ஹரிவராசனம் => ஹரிவராச
சபரிமலை => சபரிமல்
கோயிலை => கோயில்
மூடுவதற்கு => மூடு
முன்பு => முன்பு
ஓதினார் => ஓதி
பாடகர்களின் => பாடகர்
இந்தப்பாடலின் => தப்பாடல்
வெவ்வேறு => வெவ்வேறு
ஜோவியைப் => ஜோவி
போதும் => போ
அதிகாரப்பூர்வமாக => அதிகாரப்பூர்வம்
குரல் => குர்
பயன்படுத்துகிறது => பயன்
அவ்வப்போது => வப்போ
இரவல்குரல் => இரவல்குர்
தபு => தபு
சோனாலி => சோனாலி
பெண்ட்ரே => பெண்
ஸ்ரீதேவி => ஸ்ரீதே
கலைஞர்களுக்காக => கலைஞர்கள்
கொடுத்துள்ளார் => கொடுத்துள்
சீதாமலட்சுமி => சீதாமலட்சுமி
திரைப்படத்திற்காக => திரைப்படத்தில்
ராமேஸ்வரிக்கு => ராமேஸ்வரி
கொடுக்கத் => கொ
விஸ்வநாத் => விஸ்
முயற்சியான => முயற்சி
சாகரா => சாகர்
சங்கமத்தில் => சங்கமம்
நடித்தார் => நடி
அதில் => அத்
நடனக் => நடன
சலங்கை => சலம்
ஒலி => ஒலி
மாற்றப்பட்டது => மாற்ற
மனோவுடன் => மனோ
இடிவியில் => இடி
சரிகமலு => சரிகமலு
நீதிபதியாக => நீதிபதி
உண்மை => உண்
திறமை => திறம்
வேட்டை => வேடு
விருந்தினர் => விருந்தி
இருவரும் => இரு
தோன்றியிருக்கிறார்கள் => தோன்றியிர்
தென்னிந்தியாவில் => தென்னிந்தி
டிவி => டிவி
யின் => யின்
ஏர்டெல் => ஏர்டெல்
சூப்பர் => சூ
சிங்கர் => சிங்கர்
ஜூனியர் => ஜூனியர்
Junior => Junior
ஜெயா => ஜெயா
யில் => யில்
ஜீ => ஜீ
தெலுங்கில் => தெலும்
சரிகமப => சரிகம
லிட்டில் => லிடு
சாம்பியன் => சாம்பியன்
போன்றவை => போன்ற
ஆம் => ஆம்
எத்திராஜ் => திராஜ்
மகளிர் => மகளிர்
முதுநிலைப் => முதுநில்
மதுரை => மதுர்
மாவட்டம் => மாவட்டம்
சோழவந்தானை => சோழ
அடுத்துள்ள => அடு
தென்கரை => தென்கர்
ஊரில் => ஊர்
மகாலிங்கம் => மகாலிங்கம்
இருந்தே => இரு
மேடையேறி => மேடையேறி
நடிக்கவும் => நடி
பாடவும் => பாட
செய்தார் => செய்
சோழவந்தான் => சோழ
அருகே => அர்
செல்லூர் => செல்லூர்
சேஷ => சேஷ
அய்யங்கார் => யங்
மிருதங்கமும் => மிருதங்கம்
பாட்டும் => பாடு
மகாலிங்கத்துக்கு => மகாலிம்
சொல்லிக் => சொல்லி
குழுவுடன் => குழு
மடங்களிலும் => மடங்
கோவில்களிலும் => கோவில்
நெருங்கிய => நெருங்கி
நண்பர் => நண்
அந்தக் => அந்த
காலத்தில் => காலம்
ஒலிபெருக்கிகள் => ஒலிபெருக்கி
அதிகமாக => அதிகம்
இல்லாததால் => இல்
பாடகர்கள் => பாடகர்
சத்தமாகப் => சத்தம்
வேண்டியிருந்தது => வேண்டியிரு
அதனால் => அதன்
அக்காலத்துப் => கால
தியாகராஜ => தியாகராஜ
பாகவதர் => பாகவதர்
செளந்தரராஜன் => செளந்தரராஜன்
தங்கள் => தங்
குரலை => குரல்
அதற்குத் => அத
தகுந்தவாறு => தகுந்தவாறு
பக்குவப்படுத்த => பக்
பாய்ஸ் => பாய்ஸ்
நாடகக் => நாடக
கம்பனியில் => கம்பனி
கிட்டப்பாவின் => கிட்ட
வாரிசு => வாரிசு
எனப் => என
புகழடைந்திருந்த => புகழடைந்திரு
நடிக்கும் => நடி
வாய்ப்புக் => வாய்
பாட்டில் => பாடு
மெய்சிலிர்த்துப் => மெய்சிலிர்
போன => போன
மெய்யப்பச் => மெய்
செட்டியார் => செட்டி
அவரை => அவரை
ல் => ்
ஏவிஎம் => ஏவிஎம்
பிரகதி => பிரகதி
பிக்சர்ஸ் => பிக்சர்ஸ்
நிறுவனத்தின் => நிறு
நந்தகுமார் => நந்தகு
கதாநாயகனாக => கதாநாயகன்
அமைத்த => அமை
பாடியபடியே => பாடி
கிருஷ்ணரைப் => கிருஷ்ணர்
எடுக்கப்பட்ட => எட்
பெறவில்லை => பெற
ஆனாலும் => ஆன்
இப்படத்தின் => படம்
பிரபலமாயின => பிரபலமாயி
பிரகலாதா => பிரகல்
சதிமுரளி => சதிமுரளி
வாமன => வாமன
அவதாரம் => அவதாரம்
பரசுராமர் => பரசுராமர்
நடித்துப் => நடி
நடித்தாலும் => நடிம்
வள்ளி => வள்ளி
பவளக்கொடி => பவளக்கொடி
நாடகங்கள் => நாடகம்
இவருக்குப் => இவர்
புகழைத் => புகழ்
இரண்டாம் => இரண்
உலகப் => உலக
போர் => போர்
முருகனாக => முருகன்
நடித்திருந்தார் => நடித்திரு
நடிகராகவும் => நடிகர்
பாடகராகவும் => பாடகர்
திரைப்படத்துறையில் => திரைப்படத்துறை
நிலையான => நிலை
இடத்தைப் => இடம்
பிடிப்பதற்கு => பிடி
அப்படம் => படம்
பெரிதும் => பெரி
காரணமாய் => காரணம்
வாரங்கள் => வாரம்
இத்திரைப்படம் => திரைப்படம்
ஓடி => ஓடி
சாதனை => சாத
படைத்தது => படை
பாரதிக்கு => பாரதி
பயிற்றுவிக்க => பயிற்றுவி
வள்ளியூர் => வள்ளியூர்
குருமூர்த்தி => குருமூர்த்தி
பாலமுரளிக்ருஷ்ணா => பாலமுரளிக்ருஷ்
கோபால => கோபால
உலகில் => உல
வளர்த்தனர் => வளர்
எலெக்ட்ரானிக்ஸ் => எலெக்ட்ரானிக்ஸ்
தொலை => தொலை
தொடர்பு => தொடர்பு
பொறியாளர் => பொறியாளர்
கிண்டி => கிண்டி
அண்ணா => அண்
பொறியியற் => பொறியி
கோவிந்தராசன் => கோவிந்தராசன்
பிறப்பு => பிறப்பு
இறப்பு => இறப்பு
சிவசிதம்பரம் => சிவசிதம்பரம்
அவையாம்பாள் => அவை
பிறப்பிடம் => பிற
கல்வி => கல்
வாணிவிலாஸ் => வாணிவிலாஸ்
பாடசாலை => பாடசால்
இளமைப் => இளமை
பருவத்தில் => பருவம்
விரும்பிப் => விரும்
தியானமே => தியா
வதனமே => வத
சந்திர => சந்திர
பிம்பமோ => பிம்
செந்தாமரை => செந்தாமர்
முகமே => முகம்
யூ => யூ
சின்னப்பா => சின்
கோடையிலே => கோடை
இளைப்பாறி => இளைப்பாறி
நிறுவனங்கள் => நிறுவனம்
சபா => சபா
கம்பெனி => கம்பெனி
இசைக்கல்வி => இசைக்கல்
இசைக்கல்லூரி => இசைக்கல்லூரி
வாழ்வின் => வாழ்
ஆரம்பத்தில் => ஆரம்
பட்டங்கள் => பட்டம்
இசைமணி => இசைமணி
சங்கித => சங்கி
வித்வான் => வி
பிடித்த => பிடி
ராகங்கள் => ராகம்
லதாங்கி => லதாங்கி
சங்கராபரணம் => சங்கராபரணம்
ஆரம்பிக்க => ஆரம்பி
பணியாற்றும் => பணி
முயற்சியை => முயற்சி
வருவது => வரு
கடினமாக => கடி
சித்ராவுடன் => சி
அடங்கிய => அடங்கி
தட்டுகளுடன் => தட்டு
சென்னைக்கு => சென்
வருமாறு => வருமாறு
பணித்தார் => பணி
வந்து => வந்
தொடர்ச்சியான => தொடர்ச்சி
இசைத்தட்டுகளை => இசைத்தட்டு
ரகுமானிடம் => ர
நாளில் => நாள்
உடனடியாக => உடனடி
கேட்டு => கேட்டு
தெனாலி => தெனாலி
அத்தினி => அத்தினி
சித்தினி => சித்தினி
வாய்ப்பளித்தார் => வாய்ப்பளி
சிவராமன் => சிவராமன்
என்கிற => என்
பெயரில் => பெயர்
திருமணத்திற்குப் => திருமணத்தி
திரைப்படங்களின் => திரைப்படம்
மலையாளம் => மலையாளம்
டாட் => டா
காம் => காம்
ஹரிஹரனுடன் => ஹரிஹரன்
கிடைத்ததை => கிடைத்ததை
குஸ்தி => குஸ்தி
கணேசனின் => கணேசன்
நடிப்பிற்கு => நடிப்பி
தந்த => த
இசையமைப்பில் => இசையமை
பிரியதர்ஷினிக்கு => பிரியதர்ஷினி
பின் => பின்
நந்தி => நந்தி
நேர்முகம் => நேர்முகம்
வின் => வின்
கிரி => கிரி
சிம்ம => சிம்ம
பலுடு => பலுடு
மாணிக்கம் => மாணிக்கம்
என => என
கன்னட => கன்னட
சினிமாவில் => சினிம்
ராம்நாத் => ராம்
உருவான => உரு
அஜ்ஜு => அஜ்ஜு
யஷ் => யஷ்
ராக்கி => ராக்கி
திரு => திரு
பாலசுப்ரமணியத்துடன் => பாலசுப்ரமணி
பாடியிருப்பது => பாடியிரு
குறிப்பிடத்தக்கது => குறிப்பிட
செலுவின => செலுவி
சித்தாரா => சி
ஜூலி => ஜூலி
நன்னெதெய => நன்னெதெ
ஹாடு => ஹாடு
சீனா => சீனா
ப்ரீத்தியிந்தா => ப்ரீத்தியி
ரமேஷ் => ரமேஷ்
ஹம்சலேகா => ஹம்சலே
குருகிரண் => குருகிரண்
பட்நாயக் => பட்
கல்யாண் => கல்யாண்
க்ருபாகர் => க்ருபாகர்
மஹேஷ் => மஹேஷ்
மஹாதேவ் => மஹா
ரவீஷ் => ரவீஷ்
பாபி => பாபி
பணியாற்றியிருக்கிறார் => பணியாற்றியிர்
நான் => ந்
பாலா => பாலா
ஆடியோவை => ஆடியோ
ஆஸ்கார் => ஆஸ்
வெளியிட்டார் => வெளியிடு
பிரியதர்ஷினி => பிரியதர்ஷினி
ஆல்பங்களுக்கும் => ஆல்பம்
ஜிங்கிள்களையும் => ஜிங்கிள்
மைசூர் => மைசூர்
பல்கலைக்கழகத்தில் => பல்கலைக்கழகம்
எச் => எச்
ஆராய்ச்சிப் => ஆராய்ச்சி
மேற்கொண்டு => மேற்கொண்டு
ஆராய்ச்சி => ஆராய்ச்சி
மேற்கொண்ட => மேற்கொண்ட
பெருமை => பெரும்
சாரும் => சார்
பஞ்சாப் => பஞ்
அம்ரித்ஸரில் => ரித்ஸர்
வெளியானத் => வெளி
அபினேத்திரி => அபினேத்திரி
லதா => லதா
மங்கேஷ்கர் => மங்கேஷ்கர்
என்பவருடன் => என்ப
முண்டா => முண்
சவுத்ஹால் => சவுத்ஹ்
பஞ்சாபி => பஞ்
தொகுப்பை => தொகு
லக்ஷ்மிகாந்த் => லக்ஷ்மி
பியாரிலால் => பியாரில்
சேர்ந்தார் => சேர்
சமயத்தில் => சமயம்
ரட்சகன் => ரட்சகன்
எசான் => எசான்
லாய் => லாய்
இயக்குநராக => இயக்குநர்
அறிமுகமான => அறிமுகம்
தஸ் => தஸ்
இந்தப் => இந்த
திடீரென => தி
காலமானதால் => காலம்
முடிவடையவில்லை => முடிவடை
பாடல்களின் => பாடல்
ஆல்பம் => ஆல்
வெளியிடப்பட்டது => வெளியிட
வாரம் => வாரம்
நாராயணுடன் => நாராயண்
தஸ்யும் => தஸ்ய்
வெளியீடாக => வெளியீ
லோய் => லோய்
ஆகியோரது => ஆகியோர
ஜிங்கில்கள் => ஜிங்கில்
அசல் => அசல்
ஆல்பங்களை => ஆல்பம்
மிஷன் => மிஷன்
காஷ்மீர் => காஷ்மீர்
யாதீன் => யாதீன்
சாத்தியா => சாத்தியா
வெற்றிகரமான => வெற்றிகரம்
சேகர் => சேகர்
தின் => தின்
லலித் => லலி
மிகப்பெரிய => மிகப்பெரி
யாஷ் => யாஷ்
ராஜ் => ராஜ்
பிலிம்ஸ் => பிலிம்ஸ்
தயாரிப்பில் => தயாரி
தூம் => தூம்
பன்டி => பன்டி
அவுர் => அவுர்
பாபி => பாபி
சலாம் => சல்
நமஸ்தே => நமஸ்தே
ஃபனா => ஃபனா
த => த
ரா => ரா
ரம் => ரம்
பம் => பம்
ஜூம் => ஜூம்
பராபர் => பரா
ஜூம் => ஜூம்
சூர் => சூர்
மெலடி => மெலடி
ஆஃப் => ஆஃ
லைஃப் => லைஃப்
கபி => கபி
தாலே => தாலே
ஹார் => ஹ்
தராப் => தராப்
ரிஸ்தே => ரிஸ்
சுப் => சு
சுப் => சு
கே => கே
பன்டி => பன்டி
அவு => அவு
பாப்லி => பாப்லி
ஆஜ் => ஆஜ்
கி => கி
ராத் => ராத்
டான் => டான்
த => த
சேஸ் => சேஸ்
பிகன்ஸ் => பிகன்ஸ்
அகெய்ன் => அகெய்
போல் => போல்
நா => நா
ஹல்கே => ஹல்
ஹல்கே => ஹல்கே
ஜூம் => ஜூம்
பார்பர் => பார்
குறிப்பிடத்தக்கதாக => குறிப்பிட
சிலம்டாக் => சிலம்
மில்லியனயர் => மில்லியனயர்
அகாடமி => அகாடமி
ஜெய் => ஜெய்
ஹோ => ஹோ
பாட்டு => பாட்டு
வசனங்களைக் => வசனம்
உருதுப் => உருது
பகுதியைப் => பகுதி
அவற்றில் => அவ
பாடியது => பாடி
கிராமப்புறத்தில் => கிராமப்புறம்
பலவிதமான => பலவிதம்
வெளிப்படுத்தினார் => வெளிப்படுத்தி
பாவலர் => பாவலர்
வரதராஜன் => வரதராஜன்
தலைமையிலான => தலைமையில்
பயண => பயண
தசாப்தத்தை => தசாப்தம்
தென்னிந்தியா => தென்னிந்தி
கொண்டிருக்கையில் => கொண்டிருக்கை
பிரதமர் => பிரதமர்
ஜவகர்லால் => ஜவகர்
நேரு => நேரு
மறைவினால் => மறை
கவிஞரான => கவிஞர்
கண்ணதாசன் => கண்ணதாசன்
இரங்கற்பாவிற்கு => இரங்கற்பாவி
இசைத்தொகுப்பு => இசைத்தொகுப்பு
தழுவல் => தழு
மெட்ராஸில் => மெட்ராஸ்
பேராசிரியர் => பேராசிரியர்
தன்ராஜுடன் => தன்ராஜ்
பாடத்தைத் => பாடம்
கண்ணோட்டம் => கண்ணோட்டம்
எதிர்நிலை => எதிர்நில்
நுட்பங்களில் => நுட்பம்
தொகுத்தல் => தொ
கருவி => கரு
செயல்திறன் => செயல்திறன்
ஆய்வு => ஆய்வு
லண்டனின் => லண்டன்
மியூசிக் => மியூசி
தொலைதூர => தொலைதூர
கற்றல் => க
சேனல் => சேன்
பாடநெறியை => பாடநெறி
முடித்த => முடி
கிதாரில் => கி
தங்கப்பதக்கம் => தங்கப்பதக்கம்
வென்றவர் => வென்ற
கோபாலகிருஷ்ணனிடமிருந்து => கோபாலகிருஷ்ணனிடம்
கிட்டார் => கிடு
வாசித்தார் => வாசி
அமர்வு => அமர்வு
கிதார் => கி
கலைஞர் => கலைஞர்
கீபோர்டிஸ்ட் => கீபோர்டிஸ்
இசையமைப்பாளர்கள் => இசையமைப்பாளர்
மேற்கு => மே
வங்காளத்தைச் => வங்காளம்
சலில் => சல்
சௌதுரி => சௌதுரி
இயக்குநர்களுக்கான => இயக்குநர்கள்
அமைப்பாளராக => அமைப்பாளர்
இசையமைப்பாளராகப் => இசையமைப்பாளர்
போகிறார் => போ
சவுத்ரி => சவுத்ரி
வெங்கடேஷின் => வெங்கடேஷ்
உதவியாளராக => உதவியாளர்
பணியமர்த்தப்பட்ட => பணியமர்
திட்டங்களில் => திட்டம்
ஆர்கெஸ்ட்ரேட் => ஆர்கெஸ்
செய்வார் => செய்
வெங்கடேஷ் => வெங்கடேஷ்
உருவாக்கிய => உருவாக்கி
மெல்லிசைக் => மெல்லிசை
கோடுகளை => கோடு
வழிகாட்டுதலின் => வழிகாட்டுதல்
இசையமைப்பதைப் => இசையமைப்பதை
அதிகம் => அதிகம்
கற்றுக்கொண்ட => கற்றுக்கொண்ட
நேரமாகும் => நேரம்
காலகட்டத்தில் => காலகட்டம்
இளையராஜாவும் => இளையராஜ்
இசைக்குறிப்புகளை => இசைக்குறிப்பு
எழுதத் => எழுத
இசையமைப்புகளைக் => இசையமைப்பு
கேட்க => கே
இசைக்கலைஞர்களை => இசைக்கலைஞர்
அவர்களின் => அவர்
நேரங்களில் => நேரம்
இசைக்குறிப்புகளிலிருந்து => இசைக்குறிப்புகளில்
பகுதிகளை => பகுதி
இசைக்க => இசை
வழியுறுத்தினார் => வழியுறுத்தி
பஞ்சு => பஞ்சு
அருணாசலம் => அருணாசலம்
அன்னக்கிளி => அன்னக்கிளி
திரைபடத்திற்கான => திரைபடத்தில்
நியமித்தார் => நியமி
ஒலிப்பதிவுக்காக => ஒலிப்பதி
இசைக்குழுவின் => இசைக்குழு
கவிதை => கவிதை
மெல்லிசைகளுக்குப் => மெல்லிசைகள்
பயன்படுத்தினார் => பயன்படுத்தி
மொழிகளின் => மொழி
இணைவை => இணை
உருவாக்கியது => உருவாக்கி
பயன்படுத்தியது => பயன்படுத்தி
சூழலில் => சூழல்
செல்வாக்கை => செல்
செலுத்தியது => செலுத்தி
நடுப்பகுதியில் => நடுப்பகுதி
இயக்குனராக => இய
வளர்ந்து => வளர்
வாலி => வாலி
ஓ => ஓ
குறுப்பு => குறுப்பு
சிறீகுமாரன் => சிறீகுமாரன்
வெட்டூரி => வெட்டூரி
சுந்தரராம => சுந்தரராம
ஆச்சார்யா => ஆ
ஆட்டாரியா => ஆட்டாரி
சிறிவெண்ணிலா => சிறிவெண்
சீதாராம => சீதாராம
சாஸ்த்ரி => சாஸ்த்ரி
உதய => உதய
குல்சார் => குல்
இந்தியக் => திய
கவிஞர்கள் => கவிஞர்
பாடலாசிரியர்களுடன் => பாடலாசிரியர்
பாரதிராஜா => பாரதிராஜ்
முத்துராமன் => முத்துராமன்
மகேந்திரன் => மகேந்திரன்
பாலு => பாலு
மகேந்திரா => மகேந்திர்
பாலச்சந்தர் => பாலச்சந்தர்
மணிரத்னம் => மணிர
பிரியதர்சன் => பிரியதர்சன்
ஃபாசில் => ஃபா
வம்சி => வம்சி
சிங்கீதம் => சிங்கீதம்
சீனிவாசராவ் => சீனிவாசர்
நாக் => நா
பால்கி => பால்கி
இயக்குனர்களின் => இய
நன்றான => நல்
காட்சிகளில் => காட்சி
இயற்பெயர் => இயற்பெயர்
ராசய்யா => ராசய்யா
என்பதாகும் => என்ப
மாவட்டத்தில் => மாவட்டம்
பண்ணைப்புரத்தில் => பண்ணைப்புரம்
இராமசாமி => இராமசாமி
சின்னத்தாயம்மாள் => சின்னத்தாயம்
தாவீது => தாவீது
டேனியல் => டேனி
அமர் => அமர்
மூவரும் => மூ
உடன்பிறப்புகள் => உடன்பிறப்பு
மனைவியின் => மனை
ஜீவா => ஜீவா
பிள்ளைகள் => பிள்ளை
தமையனார்கள் => தமை
பாஸ்கரன் => பாஸ்கரன்
எனப்படும் => என
ஆகியோரும் => ஆகியோர்
என்பது => என்ப
சிறுவயதிலேயே => சிறுவயதிலேய்
தேர்ச்சி => தேர்ச்சி
பெற்றிருந்தார் => பெற்றிரு
சகோதரர்கள் => சகோதரர்
மூவருடனும் => மூ
இடங்களுக்கு => இடங்கள்
நாடகக்குழுவோடு => நாடகக்குழு
சுமார் => சு
இருபதாயிரம் => இருபதாயிரம்
கச்சேரிகளிலும் => கச்சேரி
ஆம் => ஆம்
இசையமைக்கும் => இசையம்
ஆர்வத்தில் => ஆர்வம்
தன்ராஜ் => தன்ராஜ்
மாஸ்டர் => மாஸ்டர்
என்பவரிடம் => என்ப
பாணியில் => பாணி
கருவியையும் => கரு
கருவியினையும் => கருவியி
வாசிக்கக் => வாசி
இசைக்கல்லூரியில் => இசைக்கல்லூரி
தேர்வில் => தேர்
தங்கப் => தங்க
பதக்கம் => பதக்கம்
இசையமைப்பாளராக => இசையமைப்பாளர்
தமிழின் => தமிழ்
இசையினை => இசையி
தரம் => தரம்
குன்றாமல் => குல்
இசையமைத்து => இசையமை
மச்சானைப் => ம
பாத்தீங்களா => பாத்தீம்
மிகப் => மிக
அதைத் => அதை
பதினாறு => பதினாறு
வயதினிலே => வய
பொண்ணு => பொண்ணு
ஊருக்கு => ஊர்
புதுசு => புதுசு
மணம் => மணம்
கமழ => கமழ
வரவேற்பினைப் => வரவே
மட்டுமல்லாமல் => மட்டுமல்
கருநாடக => கருநாட
செவ்விசை => செவ்விசை
மெட்டுக்களில் => மெடு
பாடல்களாகிய => பாடல்
மோகன => மோகன
ராகத்தில் => ராகம்
பத்ரகாளி => பத்ரகாளி
கண்ணன் => கண்ணன்
கைக்குழந்தை => கைக்குழந்தை
ரீதி => ரீதி
கௌளை => கௌளை
கவிக்குயில் => கவிக்குய்
சின்னக் => சின்
கண்ணன் => கண்ணன்
அழைக்கிறான் => அழைக்கிறான்
போன்றன => போன்ற
புகழினைத் => புகழி
தேடித்தந்தன => தேடி
முதன் => முதன்
முறையாகத் => முறை
ஸ்டீரியோ => ஸ்டீரி
முறையில் => முறை
ப்ரியா => ப்ரியா
இசையமைத்தார் => இசையமை
ராயல் => ராய்
ஃபில்ஹார்மோனிக் => ஃபில்ஹார்மோனி
ஆர்கெஸ்டிராவில் => ஆர்கெஸ்டிர்
இசையமைப்பவர்கள் => இசையமை
மேஸ்ட்ரோ => மேஸ்ட்ரோ
அழைக்கப்படுகின்றனர் => அழை
ஆர்கெஸ்டிரா => ஆர்கெஸ்டிர்
சிம்பொனியினை => சிம்பொனியி
இன்னும் => இன்
வெளியிடவில்லை => வெளியிட
என்றாலும் => எல்
திரைப்படக் => திரைப்பட
கலைஞர்களால் => கலைஞர்
அழைக்கப்படுகின்றார் => அழை
ஓடிடி => ஓடிடி
பிரத்தியேக => பிரத்தியே
இணையம் => இணையம்
ஒன்றைத் => ஒல்
தொடங்கியுள்ளார் => தொடங்கியுள்
சேலம் => சேலம்
மாடர்ன் => மாடர்
தியேட்டர்ஸ் => தியேட்டர்ஸ்
நிறுவனத்தில் => நிறு
வேலைக்குச் => வேலை
தயாரிப்பு => தயாரிப்பு
நிறுவனங்களில் => நிறுவனம்
அக்காலத்தில் => காலம்
நடிகர்கள் => நடிகர்
மாதச் => மாத
சம்பளத்தில் => சம்பளம்
நியமிக்கப்படுவது => நியமி
வழக்கம் => வழக்கம்
அங்கு => கு
வேலை => வேலை
செய்யும் => செய்
திரைப்படத்தைத் => திரைப்படம்
முதன்முதலாக => முதன்முதல்
பாடலைத் => பாடல்
தனித்தும் => தனி
மற்றப் => மற்ற
ராணியுடன் => ராணி
இணைந்தும் => இணை
தனித்துப் => தனி
கலப்படம் => கலப்படம்
பெற்றவராக => பெற்ற
இருந்தும் => இரு
நகைச்சுவை => நகைச்சு
நடிகர்களுக்குக் => நடிகர்
கொடுக்கவே => கொ
எனினும் => என்
அமுதவல்லி => அமுதவல்லி
மகாலிங்கத்துடன் => மகாலிம்
தத்துவக் => தத்
கலையுடன் => கலை
சங்கீத => சங்கீ
ஞானத்தை => ஞா
வெளிப்படுத்துவதாக => வெளி
சிறிது => சிறிது
காலம் => காலம்
நிலையத்தில் => நிலையம்
பரமக்குடிக்கு => பரமக்குடி
இளையான்குடி => இளையான்குடி
ஊரைப் => ஊரை
பூர்வீகமாகக் => பூர்வீகம்
அந்தோனி => தோனி
தேவராஜ் => தேவராஜ்
ரெஜினாமேரி => ரெஜினாமேரி
நிர்மலா => நிர்
பெற்றோருக்கு => பெற்றோர்
லூர்து => லூர்
ஈசுவரி => ஈசுவரி
ஜெமினி => ஜெமினி
ஸ்டூடியோவில் => ஸ்டூடியோ
குழுப்பாடகியாக => குழுப்பாடகி
இருந்தவர் => இரு
ஈஸ்வரியின் => ஈஸ்வரி
லூர்துமேரி => லூர்துமேரி
ராஜேஸ்வரி => ராஜேஸ்வரி
எழும்பூரில் => எழும்பூர்
மாநிலப் => மாநில
பெண்கள் => பெண்
உயர்நிலைப் => உயர்நில்
இறந்து => இற
விட்டார் => விடு
அமல்ராஜ் => அமல்ராஜ்
அஞ்சலி => சலி
கலந்துகொண்டார் => கலந்துகொண்
பாக்கியராஜின் => பாக்கியராஜ்
மகள் => மகள்
பாக்யராஜ் => பாக்யராஜ்
இவருடன் => இவர்
இல் => இ்
திரைத்துறையில் => திரைத்துறை
நுழைந்தார் => நுழை
பாக்யராஜின் => பாக்யராஜ்
அறிமுகத்தின் => அறிமுகம்
பரிஜாதம் => பரிஜாதம்
பரிந்துரைத்தார் => பரிந்துரை
உன்னைக் => உன்
கண்டேன் => கண்டேன்
ஆண்டின் => ஆண்
பத்து => பத்
பட்டியலிடப்பட்டது => பட்டியலிட
படத்துக்கு => பட
விமர்சன => விமர்ச
சிஃபி => சிஃ
தரணின் => தரண்
ஒரு => ஒரு
சிறப்பம்சமாக => சிறப்பம்சமாக
குறிப்பிட்டது => குறிப்பிட்ட
ரீதியாகவும் => ரீதி
வெற்றியாகவும் => வெற்றி
ஆனது => ஆனது
புதுமுகங்கள் => புதுமுகம்
குறைந்த => குறை
செலவில் => செல
எடுக்கப்பட்ட => எடுக்கப்பட்ட
சிவி => சிவி
திகில் => தி
படமாகும் => படமா
நேர்மறையான => நேர்மறை
விமர்சனங்களைப் => விமர்சனம்
விமர்சகர்களால் => விமர்சகர்
பாராட்டப்பட்டது => பாராட்ட
சாதகமான => சாதகம்
போதிலும் => போ
ரீதியாக => ரீதி
மோசமாக => மோசம்
தோல்வியடைந்தது => தோல்வியடை
லாடம் => லாடம்
வெளியிடப்பட்டன => வெளியிடப்பட்ட
ஹிப் => ஹி
ஹாப் => ஹா
அடிப்படையாகக் => அடிப்படை
கொண்டது => கொண்ட
மலேசிய => மலேசி
ராப்பர்கள் => ரா
டாக்டர் => டாக்டர்
பர்ன் => பர்
எம்ஸி => ஸி
ஜெஸ் => ஜெஸ்
இடம்பெற்றிருந்தனர் => இடம்பெற்றிரு
சாலமன் => சாலமன்
இப்படமும் => படம்
பாக்ஸ் => பாக்ஸ்
ஆபிஸில் => ஆபிஸ்
குண்டாக => குண்
மாறி => மாறி
வாழ்க்கையின் => வாழ்க்கை
முன்னேற்றத்துக்கு => முன்னேற்ற
உதவியது => உதவி
ஆம் => ஆம்
வெளியீடான => வெளியீ
பரத் => பர
தம்பிக்கு => தம்பி
ஊரு => ஊரு
ரீதியான => ரீதி
இதன் => இதன்
சித்து => சி
இல் => இ்
இதறகாக => இதற
ஆகியோரை => ஆகியோர்
பாடச் => பாட
பிரித்விராஜ் => பிரித்விராஜ்
சுகுமாரன் => சுகுமாரன்
த்ரில்லர் => த்ரில்லர்
மலையாளத்தில் => மலையாளம்
சல்சா => சல்
அடிப்படையிலான => அடிப்படையில்
படமான => படமா
போடா => போடா
போடி => போடி
அல்லாத => அல்
பணிகளிலும் => பணி
ஈடுபட்டுள்ளார் => ஈடுபட்டுள்
மைக்கேல் => மைக்கேல்
ஜாக்சனுக்கு => ஜாக்சன்
காணிக்கையாக => காணிக்கை
சிங் => சிம்
மோர் => மோர்
டைம் => டைம்
ஒற்றை => ஒ
உருவாக்கினார் => உருவாக்கி
தனது => தன
குழந்தைப்பருவத்தில் => குழந்தைப்பருவம்
தாக்கம் => தாக்கம்
செலுத்தியவர் => செலுத்தி
ஜாக்சனை => ஜாக்ச
பாடகர்களால் => பாடகர்
வழங்கப்பட்டது => வழம்
காணொளி => காணொளி
தொகுப்பாகவும் => தொகு
சேலஞ்சர் => சேலஞ்சர்
பீச் => பீ
கைப்பந்து => கை
வாகையர் => வாகையர்
போட்டிக்கான => போட்டி
கருப்பொருள் => கருப்பொர்
அமைத்தார் => அமை
விளம்பரங்களுக்கு => விளம்பரங்கள்
ஜிங்கிள் => ஜிங்கிள்
இசையமைப்பதைத் => இசையமைப்பதை
தமிழ்நாடு => தமிழ்நாடு
பிரீமியர் => பிரீமியர்
லீக்கின் => லீ
அணியான => அணி
ரூபி => ரூபி
வாரியர்ஸுக்கு => வாரியர்ஸ்
அணி => அணி
கீதங்களை => கீதம்
பன்முகத் => பன்மு
வாய்ந்த => வாய்
ராஜேந்தர் => ராஜேந்தர்
பதிப்பு => பதிப்பு
கீதத்தில் => கீதம்
எழுதியுள்ளார் => எழுதியுள்
கீதத்திற்கு => கீதத்தி
குரலை் => குரல்
இரண்டையும் => இரண்
சனவரியில் => சனவரி
யாரு => யாரு
கிட்ட => கிட்ட
ஏறுதழுவல் => ஏறுதழு
கீதத்தை => கீதம்
சல்லிக்கட்டு => சல்லிக்கட்டு
ஆதரவு => ஆதரவு
போராட்டங்களுக்கு => போராட்டங்கள்
உருவாக்கினர் => உருவாக்கி
மார்ச்சில் => மார்
சிவாங்கி => சிவாங்கி
கிருஷ்ணகுமாருடன் => கிருஷ்ணகு
கவின் => கவ்
தேஜு => தேஜு
அஸ்வினி => அஸ்வினி
ஆகியோரைக் => ஆகியோர்
அஸ்கு => அஸ்
மாரோ => மாரோ
இதை => இதை
டோங்லி => டோங்லி
ஜம்போ => ஜம்
இயக்கினர் => இயக்கி
செப்டம்பரில் => செப்டம்
தீட்சிதா => தீட்சி
மாணிக்கத்தை => மாணிக்கம்
ஜான்ஸ் => ஜான்ஸ்
பாஸ்கோ => பாஸ்
மெட்ரிகுலேஷன் => மெட்ரிகுலேஷன்
மேல்நிலைப்பள்ளி => மேல்நிலைப்பள்ளி
ஜெம் => ஜெம்
பள்ளிகளில் => பள்ளி
ஜயராஜின் => ஜயராஜ்
காக்க => கா
செல்லமே => செல்லம்
அந்நியன் => நியன்
பணியாற்றத் => பணியாற்ற
கெட்டவன்னு => கெட்ட
பேர் => பேர்
எடுத்த => எடு
நல்லவன்டா => நல்ல
பிஸ்தா => பிஸ்
தக்கு => தக்
முக்கு => ம்
திக்கு => தி
தாலம் => தாலம்
முருங்கைக்காய் => முருங்கை
சில்லுகள் => சில்லு
மானாட => மானாட
மயிலாட => மயிலாட
உயிர்மெய் => உயிர்மெய்
தாலாட்டு => தாலாட்டு
வளர்ந்தவர் => வளர்
சிதம்பரம் => சிதம்பரம்
கலைவாணர் => கலைவாணர்
கிருஷ்ணனின் => கிருஷ்ணன்
நாடகக்குழுவில் => நாடகக்குழு
வாசித்தவர் => வாசி
சத்யாவுக்கு => சத்
காலையில் => காலை
எழுப்பி => எழு
மரபிசையை => மரபிசை
கற்பிக்கத் => கற்பி
துவங்கினார் => துவங்கி
நாஞ்சில் => நாஞ்
சாம்பசிவம் => சாம்பசிவம்
சீதா => சீதா
ஆழமாகச் => ஆழமா
சொல்லித் => சொல்லி
தந்தனர் => த
புகழ்வாய்ந்த => புகழ்
வசீகரா => வசீகரா
கீரவாணி => கீரவாணி
குழுக்களின் => குழ்
கீபோர்ட் => கீபோர்
கலைஞரானார் => கலைஞர்
முதன்மை => முதன்
வாசிப்பாளர் => வாசிப்பாளர்
சன் => சன்
நிகழ்ச்சிகளுக்கு => நிகழ்ச்சிகள்
துவக்கப் => துவ
இசையமைப்பது => இசையமை
பேண்ட் => பேண்
தலைவராக => தலை
மாறுவது => மாறு
அடுத்தடுத்து => அடுத்தடு
முன்னேற்றம் => முன்னேற்றம்
தொலைக்காட்சித் => தொலைக்காட்சி
தொடர்களுக்கு => தொடர்கள்
விருதுகள் => விருது
சரவணன் => சரவணன்
மீனாட்சி => மீனாட்சி
தொடரின் => தொடர்
அடையாள => அடையாள
இசையான => இசை
ஏலேலோஏலேலே => ஏலேலோஏலேலே
கைவண்ணத்தில் => கைவண்ணம்
உருவானது => உரு
இசையமைத்தபோது => இசையமைத்தபோ
விளம்பரப் => விளம்பர
ஜிங்கில்ஸ் => ஜிங்கில்ஸ்
பாலபாரதி => பாலபாரதி
சிற்பி => சிற்
கலைஞராகவும் => கலைஞர்
நிரலராக => நிரலர்
சவுண்ட் => சவுண்
புரோகிராமர் => புரோகிராமர்
முதன்முதலில் => முதன்முதல்
ஏன் => ஏன்
இப்படி => படி
மயக்கினாய் => மயக்கின்
வெளிவரவில்லை => வெளிவர
இதன்பிறகு => இதன்பிறகு
புகழ்பெற்றார் => புகழ்பெ
திறமையான => திறமை
பாடகர்களை => பாடகர்
தேடி => தேடி
ஸ்ரீனிவாசன் => ஸ்ரீனிவாசன்
சாரதியை => சாரதி
கவனித்தார் => கவனி
சான்று => சான்று
தேவை => தேவை
சிறிய => சிறி
பகுதியை => பகுதி
ஏய் => ஏய்
ரொம்ப => ரொம்
அழகாய் => அழ
இருக்கே => இர்
முன்னோடி => முன்னோடி
இடைவேளையின் => இடைவேளை
பகுதிகளில் => பகுதி
ஜயராஜ் => ஜயராஜ்
வசுக்கள் => வச்
கருவுக்காக => கரு
குரலைப் => குரல்
வருடத்தில் => வருடம்
தூது => தூது
வருமா => வருமா
தனிப்பாடலாகப் => தனிப்பாடல்
பரவலான => பரவல்
இவருக்குக் => இவர்
ஆசிய => ஆசி
விளையாட்டுப் => விளையாட்டு
ஜூலை => ஜூலை
ஆர்வமாக => ஆர்வம்
செயல்படும் => செயல்
மையத்தைத் => மையம்
ஜாஸ் => ஜாஸ்
அறிந்த => அறி
வந்துள்ளார் => வந்துள்
குழுவிசையில் => குழுவிசை
சுசீலா => சுசீல்
சாந்தோம் => சா
சர்ச்சில் => சர்
லாசரஸ் => லாசரஸ்
மெட்ராஸ் => மெட்ராஸ்
குழுவிசை => குழுவிசை
பியானே => பி
வாசிப்பவரும் => வாசி
ஜோத்பூரில் => ஜோத்பூர்
ஜெய்ப்பூரில் => ஜெய்ப்பூர்
மகாராணி => மகாராணி
கடற்படை => கடற்படை
அதிகாரி => அதிகாரி
பாஜ்பாய் => பாஜ்
பியுஷ் => பியுஷ்
பாண்டே => பாண்
பிரசூன் => பிரசூன்
நிறுவனங்களை => நிறுவனம்
வருகின்றனர் => வரு
அவர்களுக்கு => அவர்கள்
ரமா => ரமா
பத்திரிகையாளர் => பத்திரிகையாளர்
தூர்தர்ஷன் => தூர்தர்ஷன்
வாசிப்பவர் => வாசி
திரிப்தி => திரிப்தி
ஆர்வலர் => ஆர்வலர்
சுற்றுலா => சுற்றுல்
நிபுணர் => நிபுணர்
அருணின் => அருண்
தாயும் => தாய்
நடிகையாவார் => நடிகை
புரோ => புரோ
டீன்ஸ் => டீன்ஸ்
இசைக்குழுவை => இசைக்குழு
டிவியில் => டிவி
இசைக்குழு => இசைக்குழு
போட்டிக்காக => போட்டி
ட்யூன்ஸ் => ட்யூன்ஸ்
குறும்படங்கள் => குறும்படம்
ஆவணப்படங்கள் => ஆவணப்படம்
சுயாதீன => சுயாதீ
இறங்கினார் => இறங்கி
ட்யூன்ஸின் => ட்யூன்ஸ்
பகுதியாக => பகுதி
லேபிள் => லேபிள்
சரேகாமா => சரே
ஓ => ஓ
லா => லா
லா => லா
ஸ்டுடியோவில் => ஸ்டுடியோ
ஆல்பத்தை => ஆல்
வென்றதும் => வென்ற
பதிவுசெய்ததும் => பதிவுசெய்
ஏஸ் => ஏஸ்
பாலசந்தருக்கு => பாலசந்தர்
எழுதினார்கார்த்திக் => எழுதினார்கார்த்தி
ஐயர் => ஐயர்
ஓரு => ஓரு
கூடாய் => கூ
பாசம் => பாசம்
நிலை => நிலை
லில்டிங் => லில்டிம்
உற்பத்தி => உற்பத்தி
மதிப்புகளில் => மதிப்பு
இந்து => து
மதிப்பாய்வு => மதிப்பாய்வு
செய்ததன் => செய்ததன்
நிகழ்ச்சியின் => நிகழ்ச்சி
டான்சர் => டான்சர்
தனஞ்சயன்கள் => தனஞ்சயன்
ஒலியம் => ஒலியம்
தயாரிப்பின் => தயாரி
நாடகப் => நாடக
பணிகளை => பணி
துவந்தா => துவ
யுதம் => யுதம்
ஜெகதினாய் => ஜெகதின்
அஜிதிடிவோம் => அஜிதிடி
குறும்படங்களில் => குறும்படம்
வழிவகுத்த => வழிவகு
திட்டத்திற்கு => திட்டத்தி
பதிவின் => பதி
கார்த்திகேயாவை => கார்த்திகேய்
சந்தித்தார் => சந்தி
மதுமிதா => மதுமி
இருமொழி => இருமொழி
மூடு => மூடு
முக்கல்லோ => ம்
செப்பலாண்டே => செப்பலாண்
மூணே => மூணே
மூணு => மூணு
வார்த்தை => வார்
வெளியீட்டு => வெளியீட்டு
முதன்முறையாக => முதன்முறை
கார்த்திகேயாவுடன் => கார்த்திகேய்
பியானோவில் => பியானோ
வலிமையை => வலிமை
ஒப்பிட்டார் => ஒப்பிடு
அன்றுமுதல் => அன்றுமு
ஒளிபரப்பட்ட => ஒளிபர
புராண => புராண
தொடர் => தொடர்
தலைப்பு => தலைப்பு
கடவுள் => கட
முருகன் => முருகன்
டிராக் => டிரா
அண்ட் => அண்
தீம் => தீம்
இசையமைத்துள்ளார் => இசையமைத்துள்
சேதுபதி => சேதுபதி
தொகுத்து => தொகு
வழங்கும் => வழங்
நம்ம => நம்ம
ஊரு => ஊரு
ஹீரோ => ஹீரோ
நிகழ்ச்சிக்கும் => நிகழ்ச்சி
கார்த்திகேயருக்கு => கார்த்திகேயர்
செங்கல்பேட்டை => செங்கல்பேடு
ரங்கநாதன் => ரங்கநாதன்
சுகன்யா => சுகன்
பிரேமலதா => பிரேமல
சத்தார் => ச
கார்த்திகேயா => கார்த்திகேய்
மிருதங்கம் => மிருதங்கம்
வீரர் => வீரர்
மூர்த்தியின் => மூர்த்தி
பேரன் => பேரன்
தாணு => தாணு
சுப்பிரமணிய => சுப்பிரமணி
வயலின் => வயல்
க்கு => க்கு
தடமறிவதாக => தடமறி
ஆதாரத்திலிருந்து => ஆதாரத்தில்
தலைமுறை => தலைமுறை
மூதாதையர்கள் => மூதாதையர்
நீதிமன்ற => நீதிமன்ற
இசைக்கலைஞர்கள் => இசைக்கலைஞர்
பிரவீனா => பிரவீன்
ராமனை => ராம
ஆஷாவின் => ஆஷா
தெற்கு => தெ
மும்பையின் => மும்பை
பெடார் => பெ
சாலை => சாலை
பகுதியில் => பகுதி
பிரபுகுஞ்ச் => பிரபுகுஞ்
ஆப்டில் => ஆ
அமைந்துள்ளது => அமைந்துள்ள
ஆம் => ஆம்
வயதான => வய
கண்பத்ராவ் => கண்ப
போஸ்லேவுடன் => போஸ்லே
சென்றுவிட்டாஎ => சென்றுவிட்டாஎ
அவர்கள் => அவர்
ல் => ல்
பிரிந்தனர் => பிரி
பேரக்குழந்தைகள் => பேரக்குழந்தை
குழந்தைகளில் => குழந்தை
ஹேமந்த் => ஹேம
குமாரின் => கு
பெயரிடப்பட்டது => பெயரிட
ஆரம்ப => ஆரம்
பெரும்பாலான => பெரும்பால்
நேரங்களை => நேரம்
விமானியாகக் => விமானி
கழித்தார் => கழி
போஸ்லேவின் => போஸ்லே
வர்ஷா => வர்ஷ்
தற்கொலை => தற்கொல்
ஆகும் => ஆக்
சண்டே => சண்
அப்சர்வர் => சர்
ரெடிஃப் => ரெடிஃ
பத்திரிகையின் => பத்திரிகை
கட்டுரையாளராக => கட்டுரையாளர்
இயக்கப் => இய
பிரிவினை => பிரி
சைதன்யா => சைதன்
சிந்து => சி
ஹேமந்தின் => ஹேம
அங்கமாக => கமாக
கருதப்படுகின்றனர் => கருத
பாய் => பாய்
உறுப்பினராக => உறுப்பி
எ => எ
பாய்ஸ் => பாய்ஸ்
உஷா => உஷா
மீனா => மீனா
ஹிருதநாத் => ஹிரு
இயக்குநர்கள் => இயக்குநர்
சாங்லியில் => சாங்லி
கோர் => கோர்
குக்கிராமத்தில் => குக்கிராமம்
பகுதி => பகுதி
மகாராட்டிரத்தில் => மகாராட்டிரம்
சாங்க்லி => சாங்க்லி
உள்ளது => உள்ள
மராத்திய => மராத்தி
மேதையான => மேதை
தீனநாத் => தீன
கொங்கனி => கொங்கனி
மரபினைச் => மரபி
குராத்தினைச் => குராத்தி
செவந்தி => செவந்தி
தந்தையார் => தந்தை
திரையரங்கு => திரையரம்
சாஸ்த்ரீய => சாஸ்த்ரி
வித்வானாவார் => வி
இருக்கும் => இர்
பொழுது => பொழுது
குடும்பம் => கு்
புனேவில் => புனே
கோல்ஹாபூரிற்கு => கோல்ஹாபூரி
குடிபெயர்ந்தது => குடிபெயர்
அங்கிருந்து => க்
மும்பைக்கு => மும்பை
அவரும் => அவர்
சகோதரியான => சகோதரி
அவர்களும் => அவர்
குடும்பத்தைப் => கு்
பேணுவதற்காக => பேணுவதல்
துவங்கினார்கள் => துவங்கி
சலா => சலா
நவ => நவ
மொழிப்பாடலை => மொழிப்பாடல்
மாஜா => மாஜா
பல் => பல்
இந்தப்படத்திற்கு => தப்படத்தி
தத்தா => த
தவ்ஜேகர் => தவ்ஜேகர்
ஸாவன் => ஸா
ஆயா => ஆயா
ஹன்ஸ்ராஜ் => ஹன்ஸ்ராஜ்
பெஹ்ல் => பெஹ்
சுனரியா => சுனரி
பாடியதும் => பாடி
இந்தியில் => தி
தனியாக => தனி
இந்தித் => தி
திரைப்படப்பாடல் => திரைப்பட
ராத் => ரா
படத்திற்காகும் => படத்தில்
குடும்பத்தின் => கு்
விருப்பத்திற்கு => விருப்பத்தி
மாறாக => மாறா
முற்பகுதியில் => முற்பகுதி
பாடகர்களான => பாடகர்கள்
கீதா => கீதா
தத் => தத்
சம்ஷாத் => சம்ஷ்
பேகம் => பேகம்
நடிகர்களுக்கும் => நடிகர்
திரைப்படங்களுக்கும் => திரைப்படம்
பாடுவதில் => பாடு
ஆதிக்கம் => ஆதிக்கம்
செலுத்தி => செலுத்தி
வந்தனர் => வ
அவ்வாறு => வாறு
மறுக்கும் => மற்
பாடலகளையோ => பாடல
அல்லது => அல்ல
நடிகைகளின் => நடிகை
படப் => பட
பாடல்களையே => பாடல்
பாலிவுட்டில் => பாலிவுடு
அதிகமான => அதிகம்
இவற்றில் => இவ
நிதியில் => நிதி
தயாரிக்கப்பட்ட => தயாரி
கிரேடு => கிரேடு
படங்களாக => படங்கள்
முந்தைய => மு
குரேஷி => குரேஷி
சஜ்ஜாத் => சஜ்ஜ்
உசேன் => உச்
இசையமைத்தனர் => இசையமை
மக்களின் => மக்
கவனத்தினை => கவனத்தி
சாங்டில் => சாம்
பாடியதால் => பாடி
பரவலாக => பரவல்
விளைவாக => விளை
பிமல் => பிம்
ராய் => ராய்
பரினிதாவில் => பரினி
அளித்தார் => அளி
பூட் => பூ
போலிஷ் => போலிஷ்
ரபியுடன் => ரபி
நான்ஹே => நான்ஹ்
முன்னே => முன்
பச்சே => பச்சே
ஒப்புக்கொண்டத்ன் => ஒப்புக்கொண்ட
தேவை => தேவை
மூன்றாம் => மூல்
பிறை => பிறை
சத்மாவாக => சத்
ரீமேக் => ரீமே
திரைப்படத்திற்காகப் => திரைப்படத்தில்
எங்கா => கா
ஓரு => ஓரு
பாட்டுக்காரன் => பாட்டுக்காரன்
செண்பகமே => செண்பகமே
குறிப்பிடத் => குறிப்பிட
தகுந்த => தகு
கமல்ஹாசனின் => கமல்ஹாசன்
அரசியல் => அரசி
ஹே => ஹே
ராமின் => ரா
மையக் => மைய
கருத்துப் => கரு
பார்த்த => பார்
பார்வைக்கொரு => பார்வைக்கொரு
ரங்கீலா => ரங்கீல்
மறுபிரவேசம் => மறுபிரவேசம்
தன்ஹா => தன்ஹ்
தன்ஹா => தன்ஹா
ரங்கீலா => ரங்கீல்
ரே => ரே
பாடல்களாக => பாடல்கள்
ரஹ்மானும் => ரஹ்
முஜே => முஜ்
ரங் => ரங்
தே => தே
தக்ஷக் => தக்ஷ
ராதா => ரா
ஜலே => ஜலே
நாராயணனுடன் => நாராயணன்
கஹின் => கஹ்
ஆக் => ஆக்
லாகே => லாகே
பன்வேர் => பன்வேர்
வெண்ணிலா => வெண்
வெண்ணிலா => வெண்ணிலா
இருவர் => இரு
செஒடம்பர் => செஒடம்
மாதம் => மாதம்
அலைபாயுதே => அலைபாயு
துவன் => து
துவன் => துவன்
மீனாக்ஷி => மீனாக்ஷி
வயதாக => வயதா
சான் => சான்
பிரான்சிஸ்கோ => பிரான்சிஸ்
விரிகுடாப் => விரிகு
பகுதிக்குச் => பகுதி
சென்றனர் => சென்ற
ப்ரிமவுண்ட்டில் => ப்ரிமவுண்டு
வளர்ந்த => வளர்
இசைத்திறமை => இசைத்திறம்
தாயாரால் => தாய்
பேணி => பேணி
வளர்க்கப்பட்டது => வளர்
ஆசிரியர் => ஆசிரியர்
ரிதம் => ரிதம்
புளூஸ் => புளூஸ்
மிசன் => மிசன்
ஜோஸ் => ஜோஸ்
பட்டப்படிப்பை => பட்டப்படி
பெர்க்லி => பெர்க்லி
பொறியியலில் => பொறியியல்
கல்லூரிக் => கல்லூரி
காலத்திலிருந்தே => காலத்திலிரு
தொடர்ச்சியாக => தொடர்ச்சி
இந்தியாவிற்கு => தியாவி
டிசம்பர் => டிசம்
மார்கழி => மார்கழி
உற்சவங்களில் => உற்சவம்
கலந்து => கல
கடல் => கடல்
புகழின் => புகழ்
உச்சத்திற்குச் => சத்தி
என்னோடு => என்
இருந்தால் => இருந்தால்
பிலிம்பேர் => பிலிம்பேர்
அச்சம் => அச்சம்
மடமையடா => மடமையடா
தள்ளிப் => தள்ளி
போகாதே => போகாதே
என்னை => என்
நோக்கி => நோக்கி
பாயும் => பாய்
தோட்டா => தோட்டா
மறு => மறு
பேசாதே => பேசாதே
நின்னு => ந்
கோரி => கோரி
அடிக்க => அடி
அடிக்க => அடிக்க
பிரபலமானவையாகும் => பிரபலம்
கண்ணூரைச் => கண்ணூர்
டெல்லி => டெல்லி
இடங்களில் => இடங்
வளர்ந்தார் => வளர்ந்தார்
முதுகலை => முதுகல்
மேலாண்மை => மேலாண்
பொருளாதாரத்தில் => பொருளாதாரம்
முடித்தபின் => முடி
வங்கியில் => வங்கி
ஆண்டுகள் => ஆண்டு
வங்கிப் => வங்கி
பணியானது => பணி
உடனான => உடனா
பங்கேற்பதற்கு => பங்கே
சலிப்பான => சலி
பணி => பணி
உணர்ந்தார் => உணர்
ஆம் => ஆம்
சப்தஸ்வரங்கல் => சப்தஸ்வரம்
போட்டியாளர்களை => போட்டியாளர்
தொழிலை => தொழில்
தொடர => தொடர
முடிவு => முடிவு
செய்தார் => செய்தார்
டிஷ்யூம் => டிஷ்யூம்
அறிமுகப்படுத்தப்பட்டா => அறிமுகப்படுத்தப்பட்டா
இசைக்கருவி => இசைக்கரு
வாசிக்கும் => வாசி
ராஜுவுடன் => ராஜு
ராஹ்லாப் => ராஹ்
நான்கு => நான்
மொழியை => மொழி
அடிப்படையாக => அடிப்படை
பியான்ட் => பி
ஜெனரஸ் => ஜெனரஸ்
சுய => சுய
பெயரிடப்பட்ட => பெயரிட
இசைத்தொகுப்பை => இசைத்தொகு
வெளியிட்டனர் => வெளியிட்ட
லைட் => லை
வகைகளில் => வகை
வெளிநாடுகளிலும் => வெளிநாடு
முக்கியமானவர்கள் => முக்கியம்
மணிசர்மாவின் => மணிசர்
வசந்த => வச
முல்லை => முல்லை
போக்கிரி => போக்கிரி
ராஜாவின் => ராஜா
அடடா => அட
மழடா => மழடா
பாடல்கலுக்கு => பாடல்கல்
பிலிம்ஃபேர் => பிலிம்ஃபேர்
விருதுக்கு => விரு
பரிந்துரையை => பரிந்துரை
திரப்படத்தில் => திரப்படம்
தமன் => தமன்
குருவரம் => குருவரம்
பிரிவில் => பிரி
ஃபிலிம்பேர் => ஃபிலிம்பேர்
அளித்துள்ளார் => அளித்துள்
இராமநாதபுரம் => இராமநாதபுரம்
பரமக்குடியில் => பரமக்குடி
சிறீவைணவ => சிறீவைண
ஐயங்கார் => ஐயம்
பிராமணர் => பிராமணர்
சீனிவாசன் => சீனிவாசன்
வழக்கறிஞர் => வழக்கறிஞர்
கமல் => கமல்
இளையவர் => இளை
தமையன்மார்கள் => தமையன்
சாருஹாசன் => சாருஹாசன்
சந்திரஹாசன் => சந்திரஹாசன்
வழக்கறிஞர்கள் => வழக்கறிஞர்
சாருகாசன் => சாருகாசன்
களில்நடித்து => நடி
நளினி => நளினி
பரதநாட்டியக் => பரதநாட்டி
சகோதரர்களின் => சகோதரர்
கருத்தில் => கரும்
இவர்கள் => இவர்
குடும்பத்துடன் => கு்
குடியேறினர் => குடியேறி
சாந்தோமில் => சா
விருப்பப்படி => விரு
துறையிலும் => துறை
நடனத்துறையிலும் => நடனத்துறை
ஈடுபாடு => ஈடுபாடு
தாயாரின் => தாய்
மருத்துவர் => மரு
செட்டியாரின் => செட்டி
மனைவிக்கு => மனைவி
மருத்துவம் => மருத்துவம்
பார்ப்பதற்காக => பார்ப்பதல்
அவரிடம் => அவர்
சென்ற => சென்ற
கமலையும் => கமலை
கூட்டிச் => கூட்டி
மெய்யப்பனின் => மெய்
சரவணனின் => சரவணன்
சிபார்சில் => சி
எவிஎம் => எவிஎம்
தயாரிப்பான => தயாரி
களத்தூர் => களத்தூர்
கண்ணம்மா => கண்ணம்
நடிப்பதற்கு => நடி
ஜூன் => ஜூன்
அனைத்திந்திய => அனைத்திந்தி
திராவிட => திரா
முன்னேற்றக் => முன்னேற்ற
கழகம் => கழகம்
கட்சியில் => கட்சி
இணைந்தார் => இணை
ஜெ => ஜெ
ஜெயலலிதா => ஜெயலலி
மேடையில் => மேடை
பல்லவி => பல்ல
துபாயில் => து
குடியேறினார் => குடியேறி
ஹரி => ஹரி
பிரசாந்த் => பிர
அன்னியன் => அன்னியன்
ஷோபா => ஷோபா
சந்திரசேகருக்கு => சந்திரசேகர்
சகோதரன் => சகோதரன்
மைத்துனன் => மை
விஜயின் => விஜய்
தாய்மாமா => தாய்
மகாராஷ்டிரா => மகாராஷ்டிர்
மாநிலத்தில் => மாநிலம்
ரத்னகிரி => ரத்னகிரி
தாபோல் => தாபோ்
துறைமுகம் => துறைமுகம்
நகரத்தில் => நகரம்
ஐக்கிய => ஐக்கி
அரபு => அரபு
எமிரேட்ஸில் => எமிரேட்ஸ்
எமிரேட்ஸ் => எமிரேட்ஸ்
கிறிஸ்தவ => கிறிஸ்
மிகச் => மிக
ஏழு => ஏழு
இலகுவான => இலகு
அரை => அரை
பிரிவுகளில் => பிரிவு
இருக்கும்போது => இருக்கும்போ
கேரளாவைச் => கேரள்
இசைக்கலைஞர்களுடன் => இசைக்கலைஞர்
பன்னிரண்டாவது => பன்னிரண்
வாரிய => வாரி
வித்தியாசத்துடன் => வித்தியாச
டெக் => டெ
எலக்ட்ரானிக்ஸ் => எலக்ட்ரானிக்ஸ்
தொலைத்தொடர்புகள் => தொலைத்தொடர்பு
மாதிரி => மாதிரி
பொறியியல் => பொறியி
ராஸ் => ராஸ்
அல் => அல்
கைமா => கைமா
வானொலியால் => வானொலி
ஏற்பாடு => ஏற்பாடு
செய்யப்பட்ட => செய்
கயியே => கயி
சுனியே => சுனி
பங்கேற்ற => பங்கேற்ற
தேர்வு => தேர்வு
செய்யப்பட்டார் => செய்
ஆல்பமான => ஆல்
விஸ்வசிந்தியில் => விஸ்வசிந்தி
ஆங்கிலம் => ஆங்கிலம்
ஆல்பங்களில் => ஆல்பம்
சான்றிதழ் => சான்றிதழ்
படிப்பில் => படி
பியானோவிற்கான => பியானோவில்
ஹானர்ஸ் => ஹானர்ஸ்
தரங்களையும் => தரங்
கடந்துள்ளார் => கடந்துள்
அமெரிக்காவில் => அமெரி
சிகாகோ => சிகா
ஜெர்சி => ஜெர்சி
படிப்பு => படிப்பு
செய்ய => செய்
வேண்டும் => வேண்
நோக்கத்துடன் => நோ
ஒருவேளை => ஒருவேள்
வேலையைப் => வேலை
வெறி => வெறி
அமெரிக்க => அமெரி
கட்டத்தை => கட்டம்
நிறுத்தியது => நிறுத்தி
தீபாவின் => தீபா
தேன் => தேன்
குடிச்ச => குடிச்ச
நிலவு => நிலவு
அப்போதிருந்து => போ
கண்கள் => கண்
இரண்டால் => இரண்
சுப்பிரமணியபுரம் => சுப்பிரமணியபுரம்
முழுவதிலும் => முழு
விருதுகளைப் => விருது
பரா => பரா
கில்லி => கில்லி
ரெட்டச்சுழி => ரெட்டச்சுழி
பாடியிருந்தார் => பாடியிரு
மின்மினிக்கு => மின்மினி
திரை => திரை
வேணு => வேணு
நாகவள்ளி => நாகவள்ளி
சுவாகதம் => சுவாகதம்
ராஜமணி => ராஜமணி
மீரா => மீரா
தமிழ்த்திரையிசையில் => தமிழ்த்திரையிசை
சூட்டினார் => சூட்டி
தமிழர்களை => தமிழர்
மின்மினியின் => மின்மினி
ஆத்மபந்தம் => ஆத்மபந்தம்
மரகதமணி => மரகதமணி
கீரவாணி => கீரவாணி
இசையமைத்தது => இசையமை
ரோஜா => ரோஜா
சின்ன => சின்
சின்ன => சின்
ஆசை => ஆசை
பாடியபோது => பாடியபோ
இடைவெளி => இடைவெளி
போக்கை => போ
அவர்களே => அவர்
கன்னடப் => கன்னட
ஹோலி => ஹோலி
ஷியாமலா => ஷி
பாவே => பாவே
புட்டமல்லி => புட்டமல்லி
ஹம்மிங் => ஹம்மிம்
பெட்டேகாரா => பெட்டே
சாது => சாது
கோகிலாவுடன் => கோகில்
மிடிடிரலு => மிடிடிரலு
சவிகனசுகலு => சவிகனசுகலு
ஒரியா => ஒரி
படகா => படகா
ஜான்சன் => ஜான்சன்
பம்பாய் => பம்
விருப்பமானார் => விரு
மாறியது => மாறி
பக்ஷி => பக்ஷி
வியட்நாம் => விய
காலனி => காலனி
ஸ்வயம் => ஸ்வயம்
பைத்ருகம் => பைத்ருகம்
வெல்லிடிங்கல் => வெல்லிடிம்
மேலேராம்பில் => மேலேர்
அன்வீது => அன்வீது
ஆருணி => ஆருணி
ஜின்மகலே => ஜின்ம
பெரு => பெரு
சோலமோ => சோலமோ
முத்தே => மு
நின் => நின்
தேடி => தேடி
மனாசம் => மனாசம்
கோபி => கோபி
மில்லி => மில்லி
கன்மனியே => கன்மனியே
பாடலுடன் => பா
தொழிலுக்கு => தொழில்
வாங்கினார் => வாங்கி
சிரகோடின்ஜா => சிரகோடின்ஜ்
கினக்கால் => கின
நிலகுடம் => நிலகுடம்
பாடலாக => பாடல்
ஜாய் => ஜாய்
மேத்யூவை => மேத்யூ
மகனும் => மகன்
இழந்தார் => இழ
வருடங்கள் => வருடம்
கூட => கூட
பேச => பேச
சிகிச்சைகள் => சிகிச்சை
கொச்சினில் => கொ
ஜாய்ஸ் => ஜாய்ஸ்
பெர்பார்மிங் => பெர்பார்மிம்
ஆர்ட்ஸ் => ஆர்ட்ஸ்
பள்ளியையும் => பள்ளி
ஜோசப் => ஜோச
ட்ரீஸாவின் => ட்ரீஸ்
மகளாக => மகளா
மினிமினி => மினிமினி
ரோசிலி => ரோசிலி
அழைக்கப்பட்டார் => அழை
மினி => மினி
என்றும் => எல்
கலை => கலை
கலைஞர்களைப் => கலைஞர்
வெறித்தனமாக => வெறி
கலாபவன் => கலாப
இசைக்குழுவுடன் => இசைக்குழு
தொடங்கிய => தொடங்கி
ட்ரீஸா => ட்ரீஸ்
அல்ல => அல்ல
மினியின் => மினி
கிராம => கிராம
பெரியர்முகம் => பெரியர்முகம்
செயிண்ட் => செயிண்
ஆண்ட்ரூ => ஆண்ட்ரூ
கத்தோலிக்க => கத்தோலி
வீட்டிலிருந்து => வீட்டில்
நடந்து => நட
செல்லும் => செல்
தூரத்தில் => தூரம்
அவர்களைப் => அவர்
பின்பற்றி => பின்
மினியும் => மினி
தாளத்திலும் => தாளம்
சுருதியிலும் => சுருதி
பாடக் => பாட
ஆலுவாவின் => ஆலு
பிரான்சிஸ் => பிரான்சிஸ்
படிக்கும் => படி
பங்கேற்றனர் => பங்கேற்ற
ஒருவரான => ஒரு
ஜான்சி => ஜான்சி
கலாபவனின் => கலாப
கணமெலா => கணமெல்
இளைஞர் => இளைஞர்
திருவிழா => திருவிழ்
பல்கலைக்கழக => பல்கலைக்கழ
திருவிழாவில் => திருவிழ்
ஒளி => ஒளி
பருவத்திலிருந்தே => பருவத்திலிரு
பரிசுகளை => பரிசு
அதற்குள் => அதல்
கொச்சின் => கொ
கம்யூனிகேஷன் => கம்யூனிகேஷன்
சிஏசி => சிஏசி
வழக்கமான => வழக்கம்
பாடகியாகிவிட்டார் => பாடகியாகிவிடு
படிக்க => படி
நடிக்கிறார் => நடி
நிகழ்ச்சிகளும் => நிகழ்ச்சி
பதிவுகளும் => பதிவு
இருந்ததால் => இரு
கவனம் => கவ
செலுத்த => செலு
சென்னையின் => சென்
மாம்பலத்தில் => மாம்பலம்
நடுத்தர => நடுத்தர
குடும்ப => கு்
தியாகம் => தியாகம்
ஆர்வத்தைக் => ஆர்வம்
வருமானம் => வரும்
ஈட்டுவதற்காக => ஈட்டுவதல்
வீட்டு => வீட்டு
வேலைக்காரியாக => வேலைக்காரி
உயிரோடு => உயிர்
வைத்திருக்க => வைத்திர்
திருமண => திருமண
விழாக்களிலும் => விழா
திருவிழாக்களிலும் => திருவிழா
வாய்ப்பைப் => வாய்
பெறுவதற்கு => பெறு
பெரும்பகுதி => பெரும்பகுதி
வீட்டுப் => வீட்டு
பணிபெண்ணாகவே => பணிபெண்
இல் => இ்
காத்தவராயன் => காத்தவராயன்
தெனாவட்டு => தெனாவட்டு
ஹரிதாஸ் => ஹரிதாஸ்
பாடல்களிலும் => பாடல்
வாய்ப்புகளைப் => வாய்ப்பு
இந்நிலையில் => நிலை
மேல்மருவத்தூர் => மேல்மருவத்தூர்
ஆதிபராசக்தி => ஆதிபராசக்தி
சித்தர் => சித்தர்
பீட => பீட
ஆன்மிக => ஆன்மி
குரு => குரு
அடிகளார் => அடிகள்
முன்னிட்டு => முன்னிட்டு
மாணவ => மாண
மாணவிகள் => மாண
பணிகளைச் => பணி
செய்யச் => செய்
பா => பா
இரஞ்சித்தை => இரஞ்சிம்
அப்போது => போது
காலாவை => காலா
இயக்க => இய
ஒப்பந்தமாகி => ஒப்பந்தம்
இரஞ்சித்தின் => இரஞ்சிம்
இசைக்குழுவான => இசைக்குழு
காசுலசு => காசுலசு
கலெட்டிவ் => கலெட்டி
இயற்றுவதோடு => இயற்று
உருவாக்கியுள்ளார் => உருவாக்கியுள்
ஆப்பிரோவுடன் => ஆப்பிரோ
தெருக்குரல் => தெருக்குரல்
தொகுப்புக்காக => தொகு
வெளியிடப்பட்டு => வெளியிட
சென்னையிலிருந்து => சென்னையில்
கிலோமீட்டர் => கிலோமீட்டர்
தொலைவில் => தொலை
அரக்கோணம் => அரக்கோணம்
இல்லாமல் => இல்
வளர்க்கபட்டார் => வளர்
இதனால் => இதன்
தாக்கத்துக்கு => தா
உட்பட்டார் => உட்
சாதி => சாதி
வறுமை => வ
கவிதைகள் => கவிதை
உணர்வு => உணர்வு
தவறாமல் => தவ
பாடுகிறார் => பாடு
ஆண்டும் => ஆண்
திருவையாறில் => திரு
தியாகராஜர் => தியாகராஜர்
சன்னதில் => சன்ன
நடக்கும் => நட
கச்சேரியில் => கச்சேரி
பங்குகொள்கிறார் => பங்குகொள்
திருவையாறு => திருவையாறு
மகோத்சவம் => மகோத்சவம்
தோன்றி => தோன்றி
கிருஷ்ண => கிருஷ்ண
கான => கான
நாரத => நாரத
தியாகராய => தியாகர்
பிரம்ம => பிரம்ம
முதலிய => முதலி
சபாக்களில் => சபா
அடிக்கடி => அடிக்கடி
ஆம் => ஆம்
தொகுப்பையும் => தொகு
நூறு => நூறு
தடத்தை => தடம்
கும்பகோணத்தில் => கும்பகோணம்
ரேவதி => ரேவதி
பாரம்பரியத்தில் => பாரம்பரியம்
சங்கீதம் => சங்கீதம்
வசித்து => வசி
சென்னையைச் => சென்
உடன்பிறந்த => உடன்பிற
இரட்டை => இரடு
சகோதரர்களாவார்கள் => சகோதரர்கள்
இசையமைப்பாளரான => இசையமைப்பாளர்
உதவி => உதவி
இயக்குனர்களாக => இயக்குனர்கள்
பணியாற்றியுள்ளனர் => பணியாற்றியுள்ள
பொக்கிசம் => பொக்கிசம்
மிளகா => மிள
இம்சை => சை
அரசன் => அரசன்
ஆம் => ஆம்
புலிகேசி => புலிகேசி
கோரிப்பாளையம் => கோரிப்பாளையம்
அமைத்துள்ளனர் => அமைத்துள்ள
சௌராட்டிரக் => சௌராட்டிர
தொ => தொ
அ => அ
மீனாட்சி => மீனாட்சி
என்பவரின் => என்ப
பிறந்தவர் => பிற
சுமுத்திரா => சுமுத்திர்
என்பவரைத் => என்ப
புரிந்தார் => புரி
வித்துவான் => வி
பூச்சி => பூச்சி
சிறீனிவாச => சிறீனிவாச
ஐயங்காரின் => ஐயம்
மருமகன் => மருமகன்
காரைக்குடி => காரைக்குடி
ராஜாமணி => ராஜாமணி
ஐயங்காரிடம் => ஐயம்
ஆண்டுகளாகக் => ஆண்டுகள்
சுந்தரராவ் => சுந்தரர்
நட்கர்னி => நட்கர்னி
விஜயம் => விஜயம்
ராதே => ரா
விட்டுப்போகாதேடி => போகாதேடி
ஒப்பந்தம் => ஒப்பந்தம்
மந்திரி => மந்திரி
குமாரி => குமாரி
தேவகி => தேவகி
சர்வாதிகாரி => சர்வாதிகாரி
தென்காசிக்கு => தென்காசி
அருகில் => அர்
இளந்தூரில் => இளந்தூர்
மட்டுமே => மடு
பகவதியின் => பகவதி
மாற்றாந்தாயான => மா
கிருஷ்ணம்மா => கிருஷ்ணம்
பின்னாளில் => பின்
நுழைவதற்குக் => நுழை
இருந்திருக்கிறார் => இருந்திர்
பகவதிக்கு => பகவதி
முறையான => முறை
காலாட்சேபமாகவும் => காலாட்சே
எழுதிப் => எழுதி
பாடுபவராகவும் => பாடு
மாதம் => மாதம்
ரூபாய் => ரூ
பணியில் => பணி
இந்தக் => இந்த
கால => கால
கட்டத்தில் => கட்டம்
தமிழிசை => தமிழிசை
இயக்கம் => இயக்கம்
சூடு => சூடு
நேரம் => நேரம்
கன்னடத்தில் => கன்னடம்
மொழியில் => மொழி
க்கும்தொகுப்புகள் => தொகுப்பு
விளம்பரங்களுக்காகவும் => விளம்பரங்கள்
படங்களுக்கும் => படங்
அமிர்ததரே => அமிர்ததர்
நூறு => நூறு
ஜன்மகு => ஜன்மகு
திரு => திரு
திருமதி => திருமதி
ராமாச்சரி => ராமாச்சரி
ஒலிச்சேர்க்கை => ஒலிச்சேர்
செய்துள்ளார் => செய்துள்
மாருதி => மாருதி
சுஜூகி => சுஜூகி
வாகொனார் => வாகொ
மஞ்சால் => மஞ்
சோப்பு => சோப்பு
இந்துலேகா => துலே
முடி => முடி
எண்ணெய் => எண்ணெய்
நிறுவன => நிறு
விளம்பரங்கள் => விளம்பரம்
நிறுவனங்களின் => நிறுவனம்
பொருள்களுக்காகவும் => பொருள்கள்
மாதிரியாயிருந்தார் => மாதிரியாயிரு
பாடல்களுக்கான => பாடல்கள்
நியமிக்கப்பட்டார் => நியமி
ஏசியாநெட் => ஏசியாநெ
சுவர்ணா => சு
சூப்பர்ஸ்டார் => சூப்பர்ஸ்
வாய்ஸ் => வாய்ஸ்
பெங்களூரு => பெங்களூரு
தொலைக்காட்சிகளில் => தொலைக்காட்சி
முழுப்பெயர் => முழுப்பெயர்
ராஜேஸ்வரா => ராஜேஸ்
சாய் => சாய்
சுப்ரமண்யா => சுப்ரமண்
நாகராஜ => நாகராஜ
குருவாக => குரு
ஹம்சேலேகாவின் => ஹம்சேலே
வழிகாட்டுதலில் => வழிகாட்டுதல்
பள்ளியை => பள்ளி
குறிக்கும் => குறி
விழாவில் => விழா
சந்தீப் => சந்தி
சவுதா => சவு
நன்றாகப் => நல்
பாடக்கூடிய => பாடக்கூடி
பாடகரைத் => பாடகர்
தேடியபோது => தேடியபோ
நின்னே => ந்
பெல்லாடுதா => பெல்லாடுதா
தெலுங்குத் => தெலும்
கிரேக்கவீருடு => கிரேக்கவீருடு
இவரைத் => இவரை
தேர்ந்தெடுத்தார் => தேர்ந்தெடு
வெற்றியை => வெற்றி
அளித்தது => அளி
பதிப்புகளிலும் => பதிப்பு
இதே => இதே
பாலிவுடில் => பாலிவு
டியூன் => டியூன்
கியா => கியா
சோல் => சோ்
ஜங்கிள் => ஜங்கிள்
இந்திப் => தி
ஒவர் => ஒவர்
முழுப் => முழு
டம் => டம்
பண்டி => பண்டி
ஆம் => ஆம்
சச்சின் => ச
குந்தால்கர் => குந்தால்கர்
ஆயியா => ஆயியா
டிரீமும் => டிரீம்
வேக்கப்பும் => வே
குத்தாட்டப் => குத்தாட்ட
முகர்ஜி => முகர்ஜி
ஆகியோரின் => ஆகியோர்
நடன => நடன
அசைவுக்காகவும் => அசை
பணிபுரிந்த => பணிபுரி
நிலவரப்படி => நிலவர
கருநாடகாவின் => கருநாட
சுமித்ரா => சுமி
சுதாகர் => சுதாகர்
பேசும் => பே
சுனில் => சுன்
கன்னடத் => கன்னட
பாடகியாவார் => பாடகி
குழந்தையாக => குழந்தை
இருந்தபோது => இருந்தபோ
தாயுடன் => தாய்
அரங்கங்களுக்கு => அரங்கங்கள்
செல்வதை => செல்வதை
வழக்கமாகக் => வழக்கம்
மெதுவாக => மெது
குழந்தைப் => குழ
பாடகியானார் => பாடகி
ரிசர்வ் => ரிசர்
படிப்புக்காக => படி
சிலகாலம் => சிலகாலம்
பாடுவதை => பாடுவதை
நிறுத்தினார் => நிறுத்தி
கற்றுக்கொள்வதன் => கற்றுக்கொள்வதன்
படிப்படியாக => படிப்படி
கவனத்தை => கவ
திருப்பினார் => திருப்பி
குழந்தைகளுக்காக => குழந்தைகள்
அல்லாமல் => அல்
கதாநாயகிகளுக்காக => கதாநாயகிகள்
எடுக்க => எட்
விரும்பினேன் => விரும்பினேன்
கூறுகிறார் => கூறு
நாயரிடமிருந்து => நாயரிடம்
பாரம்பரியப் => பாரம்பரி
முத்திரை => முத்திர்
பதித்தார் => பதி
திரைப்படங்களுக்குப் => திரைப்படங்கள்
இராமு => இராமு
கரியத்தின் => கரியம்
பாபுராசுவின் => பாபுராசு
இல் => இ்
திவீபு => திவீபு
கண்ணீரின் => கண்
மழையத்தும் => மழையத்தும்
பாராட்டைப் => பாராடு
ஆம் => ஆம்
பணி => பணி
செய்யத் => செய்
வள்ளத்தோள் => வள்ளத்தோள்
மேனனின் => மே
நூற்றாண்டு => நூற்றாண்டு
விழாவின் => விழா
நடனமாடப்பட்ட => நடனமாட
தனஞ்செயனின் => தனஞ்செயன்
மக்தலானா => மக்தல்
மரியம் => மரியம்
வள்ளத்தோளின் => வள்ளத்தோள்
இளையராஜாவுடன் => இளையராஜ்
பாலாஜியின் => பாலாஜி
நல்லதொரு => நல்லதொரு
செவ்வானமே => செ
பொன்மேகமே => பொன்மேகமே
வருவாயென => வருவாயென
சவால் => சவ்
சு => சு
தண்ணிய => தண்ணி
போட்டா => போடு
சந்தோசம் => சந்தோசம்
பிறக்கும் => பிறக்கும்
களின்இவருக்குத் => இவர்
வாழ்வே => வாழ்
மாயம் => மாயம்
ஏ => ஏ
ராஜாவே => ராஜா
உன் => உன்
ராஜாத்தி => ராஜாத்தி
விதி => விதி
விதி => விதி
வரைந்த => வரை
பாதை => பாதை
வழியே => வழியே
சுப => சுப
முகூர்த்தம் => முகூர்த்தம்
இரவில் => இர
எழுதும் => எழு
முழுதும் => முழுதும்
வராத => வராத
மூக்குத்தி => மூக்குத்தி
மீன்கள் => மீன்கள்
தேரில் => தேர்
வந்தாள் => வ
தேவதை => தேவதை
துறையிலிருந்து => துறையில்
கள்களின்தொகுப்புகளில் => தொகுப்பு
மன்னர்கள் => மன்
சாத்துக்குடி => சாத்துக்குடி
முத்து => மு
குலுவாலிலே => குலுவாலிலே
தலைப்புப் => தலைப்பு
தமிழ் => தமிழ்
கௌதம் => கௌதம்
விண்ணைத்தாண்டி => விண்ணைத்தாண்டி
வருவாயா => வரு
பதிப்புகளுக்காகவும் => பதிப்புகள்
சுதந்திரத்தின் => சுதந்திரம்
வது => வ
பொன்விழாவைக் => பொன்விழ்
விதத்தில் => விதம்
ரகுமானால் => ர
வெளியிடப்பட்ட => வெளியிட
வந்தே => வ
மாதரம் => மாதரம்
ஸ்ரீநிவாசின் => ஸ்ரீநி
உசேலே => உசேல்
படல் => படல்
தொகுப்பில் => தொகு
கோபாலகிருஷ்ண => கோபாலகிருஷ்ண
பாரதியின் => பாரதி
எப்போ => எ
வருவாரோ => வருவாரோ
உன்னிகிருஷ்ணனுடன் => உன்னிகிருஷ்ணன்
பாடினர் => பாடி
வாண்டட் => வாண்ட
திட்டத்துடன் => திட்ட
நுழைய => நுழை
திட்டமிட்டார் => திட்டமிடு
ராஜாவும் => ராஜா
படப்பிடிப்பு => படப்பிடிப்பு
முடிக்கப்படவில்லை => முடிக்கப்பட
முதன்மையாக => முதன்மை
இசையமைக்கிற => இசையமை
ஆர்வமுள்ள => ஆர்வம்
உறவினரான => உறவி
ராப் => ரா
பகுதிகள் => பகுதி
பாடுதல் => பாடு
போன்றவற்றில் => போன்ற
ஈடுபட்டார் => ஈடு
ஆல்பங்களுக்கான => ஆல்பங்கள்
ரீமிக்ஸ் => ரீமிக்ஸ்
முதலாவது => முதல்
வல்லவன் => வல்ல
படத்திலிருந்து => படத்தில்
லூசு => லூசு
பெண்ணே => பெண்ணே
நடிப்பு => நடிப்பு
அறிமுகத்தை => அறிமுகம்
சிலம்பரசன் => சிலம்பரசன்
கதாநாயகியின் => கதாநாயகி
நண்பராக => நண்
சகோதரரைக் => சகோதரர்
நடித்தும் => நடி
பின்வரும் => பின்
சீனுவாக => சீனு
கோடைகால => கோடைகால
பிளாக்பஸ்டராக => பிளாக்பஸ்டர்
பிரேம்ஜியை => பிரேம்ஜி
நிறுவியது => நிறு
சரோஜாவுக்காக => சரோஜ்
சகோதரருடன் => சகோதரர்
நடிப்பால் => நடி
பாராட்டுக்களைப் => பாராடு
மங்காத்தா => மங்
சேட்டை => சேடு
தோற்றமளிக்கும் => தோற்றமளி
பிரபுவின் => பிரபு
கோவாவில் => கோவா
வடக்கு => வட
கதத்தில் => கதம்
மங்காத்தாவில் => மங்
இசையமைப்பாளராகவும் => இசையமைப்பாளர்
பணியாற்றுகிறார் => பணியாற்று
செகண்ட் => செ
இன்னிங்ஸில் => இன்னிங்ஸ்
தொடர்ச்சியாகும் => தொடர்ச்சி
அகாதமி => அகாதமி
யுகேந்திரனுடன் => யுகேந்திரன்
காதலர் => காதலர்
தினம் => தி
மரியா => மரியா
பிரிவுகளிலும் => பிரிவு
அதன்பிறகு => அதன்பிறகு
தென்னக => தென்
இயக்குனர்களிடமிருந்து => இயக்குனர்களிடம்
மின்னலே => மின்
திரைப்படத்திலிருந்து => திரைப்படத்தில்
ஞாபகம் => ஞாபகம்
வெற்றியாக => வெற்றி
பலரின் => பலர்
இசையமைப்பின் => இசையமை
அன்பில் => அன்
அவன் => அவன்
இரசிகர்கள் => இரசிகர்
மனதில் => மன
இடம்பெற்றது => இடம்பெற்ற
ஜெயராஜுடன் => ஜெயராஜ்
அவருக்காக => அவர்
பாடல்களுக்கும் => பாடல்
இரசிகர்களிடமிருந்து => இரசிகர்களிடம்
வரவேற்பு => வரவேற்பு
கிடைத்துள்ளது => கிடைத்துள்ள
பிரபுவுடன் => பிரபு
பிரியாணி => பிரியாணி
நா => நா
நா => நா
பெப்பி => பெப்
நியூ => நியூ
ஜாக் => ஜா
ஸ்விங் => ஸ்விம்
மிக்ஸ் => மிக்ஸ்
தி => தி
எக்ஸ்டெண்டட் => ஸ்டெண்ட
மறு => மறு
இசைக்கலவை => இசைக்கல
பதிப்புகளும் => பதிப்பு
அறிந்தால் => அறி
அறிந்தால் => அறிந்தால்
எனற => எனற
பாடலாசிரியர் => பாடலாசிரியர்
தாமரை => தாமர்
இசைப்பயணத்தை => இசைப்பயணம்
முதலாக => முதல்
பாடுவதற்காக => பாடுவதல்
பாப்பாவினால் => பா
பொதிகை => பொதிகை
தொலைக்காட்சியிலும் => தொலைக்காட்சி
தஞ்சை => தஞ்
வாணன் => வாணன்
நிறைய => நிறை
நாடுகள் => நாடு
ராணித்தேனீ => ராணித்தேனி
வீரமும் => வீரம்
ஈரமும் => ஈரம்
அராசங்கம் => அராசங்கம்
வாமனன் => வாம
கோயம்புத்தூரைச் => கோயம்புத்தூர்
சேர்ந்தவரான => சேர்
ஆதி => ஆதி
எழுதுவதில் => எழுது
ஆர்வமாகவும் => ஆர்வம்
இசையால் => இசை
ஈர்க்கப்பட்டவராகவும் => ஈர்க்கப்பட்ட
கணினியில் => கணினி
இசைக்கோர்வை => இசைக்கோர்
மென்பொருளை => மென்பொருள்
நிறுவி => நிறு
எதாவது => எதா
பதிவுசெய்துவருவதை => பதிவுசெய்துவருவதை
யூடியூப் => யூடியூ
அறிமுகமானபோது => அறிமுகமானபோ
பதிவுசெய்த => பதிவுசெய்
ஹிப்ஹாப் => ஹிப்ஹ்
தமிழன் => தமிழன்
பதிவுசெய்தார் => பதிவுசெய்
ஆர்க்குட் => ஆர்
வழியாக => வழி
ஜீவாவுடன் => ஜீவா
நட்பு => நட்பு
ஆர்வமுள்ளவர் => ஆர்வமுள்ள
சம்பந்தமான => சம்பந்தம்
நூல்களைப் => நூல்
படிப்பது => படி
டுடோரியல் => டுடோரி
கற்றுக்கொள்வது => கற்றுக்கொள்
தீவிரமாக => தீவிரம்
இறங்கி => இறங்கி
தங்களுடைய => தங்
யூடியூபில் => யூடியூ
பதிவேற்றிவந்தனர் => பதிவேற்றி
இளநிலை => இளநில்
மூச்சாக => மூ
இறங்கப்போவதாக => இறங்கப்போ
முடிவெடுத்து => முடிவெடு
வீட்டை => வீடு
எதிர்த்து => எதிர்
புறப்பட்டார் => புற
பாதியில்விட்டுவிட்ட => பாதியில்விட்டுவிட்ட
ஜீவாவும் => ஜீவா
வீடெடுத்து => வீடெடு
தங்கினார் => தங்கி
ஆதியும் => ஆதி
பாடல்களைக் => பாடல்
ஏற்றினர் => ஏற்றி
நடத்த => நட
போதிய => போதி
பணம் => பணம்
கிடைக்காத => கிடை
சூழல் => சூழ்
நிலவியது => நில
வேறுவழியின்றி => வேறுவழி
ஊருக்கே => ஊர்
சம்மதம் => சம்மதம்
வாங்கி => வாங்கி
இல் => இ்
தமிழன் => தமிழன்
தயாரிக்க => தயாரி
திங்க் => திங்
வெளியிட்டது => வெளியிட்ட
லட்சத்துக்கும் => லட்ச
மேற்பட்டவர்கள் => மேற்பட்ட
ஆல்பத்தைப் => ஆல்
பின்தொடர => பின்தொடர
சடகோபன் => சடகோ
ராஜசுந்தரி => ராஜசுந்தரி
மயிலாப்பூரில் => மயிலாப்பூர்
பாடகியும் => பாடகி
நடிகையும் => நடிகை
சிறுவயதில் => சிறு
ஆர்வமாயிருந்த => ஆர்வமாயிரு
ராஜேசுவரியை => ராஜேசுவரி
பந்துலு => பந்துலு
அறிமுகப்படுத்தி => அறிமுகப்படுத்தி
வைத்தார் => வை
மையல் => மை
மீறுதே => மீறு
விஜயலட்சுமி => விஜயலட்சுமி
காரைக்குடியில் => காரைக்குடி
கலையகத்தில் => கலையகம்
சுதர்சனம் => சுதர்ச
ராஜேஸ்வரியை => ராஜேஸ்வரி
செட்டியாரிடம் => செட்டி
தமது => தமது
சேர்த்துக் => சேர்
வெற்றிகரமாக => வெற்றிகரம்
ஓடிய => ஓடி
ராமராஜ்யா => ராமராஜ்
திரைப்படத்தை => திரைப்படம்
மொழிமாற்றம் => மொழிமாற்றம்
கலையகம் => கலையகம்
மாறிய => மாறி
ராஜேசுவரியும் => ராஜேசுவரி
நாம் => நாம்
கருணாமூர்த்தி => கருணாமூர்த்தி
காந்தி => காந்தி
மகாத்மா => மகா
மகான் => மக்
ராஜேசுவரி => ராஜேசுவரி
பாடல்களுக்காகவே => பாடல்கள்
ஓடியது => ஓடி
வேதாள => வேதாள
ஆகா => ஆகா
ஆனந்தமானேன் => ஆனந்தம்
வாழ்க்கை => வாழ்
கண் => கண்
உன்னை => உன்
ஏமாற்றினால் => ஏமா
ராமச்சந்திரனுடன் => ராமச்சந்திரன்
சத்ரியன் => சத்ரியன்
காவல்அதிகாரி => காவல்அதிகாரி
என்னவளே => என்ன
சப்தஸ்வரங்கள் => சப்தஸ்வரம்
தொகுப்பாளராக => தொகுப்பாளர்
தோற்றம் => தோற்றம்
சித்தார்தின் => சிம்
மதுரே => மதுர்
நீரோட்டம் => நீரோட்டம்
கதல் => கதல்
கதால் => கத்
நேற்றொரு => நேற்றொரு
மேனகை => மேனகை
மன்மதா => மன்ம
லீலை => லீலை
உமா => உமா
ராமணனுடன் => ராமணன்
லீலா => லீலா
செல்ல => செல்ல
சுசித்ராவுடன் => சுசி
அதுக்கு => அத்
ருத்ரா => ரு
வீனை => வீனை
இருபதுகளில் => இருப
​​ஜானகி => ​​ஜானகி
மாமாவின் => மாமா
ஆலோசனையின் => ஆலோச
பேரில் => பேர்
சுதர்சனத்துடன் => சுதர்ச
விதியின் => விதி
விலையட்டு => விலையட்டு
ஆண்டுகால => ஆண்டுகால
ஸ்வான்சொங்காக => ஸ்வான்சொம்
கல்பனக்கலில் => கல்பனக்கல்
அம்மா => அம்
பூவனம் => பூவனம்
தேர்ந்தெடுத்து => தேர்ந்தெடு
மைசூருவில் => மைசூரு
நிகழ்ச்சியுடன் => நிகழ்ச்சி
ஜானகியின் => ஜானகி
எண்ணிக்கையிலான => எண்ணிக்கையில்
பிபி => பிபி
தனிப்பாடல்கள் => தனிப்பாடல்
பசுமையானதாக => பசுமை
கருதப்படுகிறார் => கருத
அமைப்பாளர்களுடன் => அமைப்பாளர்
முதலிடம் => மு
நாகேந்திரா => நாகேந்திர்
வரையிலான => வரையில்
அவர்களுடைய => அவர்
இசையமைப்புகளில் => இசையமைப்பு
பெரும்பாலானவற்றை => பெரும்பால்
வழங்கினர் => வழங்கி
பாலசுப்பிரமண்யம் => பாலசுப்பிரமண்யம்
கொண்டுள்ளார் => கொண்டுள்
ராஜ்யோத்சவ => ராஜ்யோத்ச
பங்களிப்பிற்காக => பங்களிப்பில்
கௌரவ => கௌர
பிரிக்க => பிரி
முடியாதவை => முடி
சரியான => சரி
உச்சரிப்பு => சரிப்பு
மொழியின் => மொழி
நுணுக்கங்களை => நுணுக்கம்
தொழில்துறையில் => தொழில்துறை
விரும்பப்பட்ட => விரும்
பாபுராஜ் => பாபுராஜ்
ஷியாம் => ஷி
எம்பி => பி
ஸ்ரீநிவாசன் => ஸ்ரீநிவாசன்
சலீல் => சலீல்
ஜனகி => ஜனகி
முற்பகுதியிலிருந்து => முற்பகுதியில்
நடுப்பகுதி => நடுப்பகுதி
ஆயிரக்கணக்கான => ஆயிரக்கண
அகராதி => அகராதி
குறித்த => குறி
கட்டளைதான் => கட்டளை
உயர்ந்த => உயர்
உயரத்திற்கு => உயரத்தி
அழைத்துச் => அழை
சென்றது => சென்ற
அதிகபட்ச => அதிகபட்ச
மலையாளி => மலையாளி
சிங்காரவேலன் => சிங்காரவேலன்
பிரபலமாக்கியது => பிரபலமாக்கி
விஸ்வநாதன் => விஸ்வநாதன்
உன்னிடத்தில் => உன்னிடம்
என்னைக் => என்
கொடுத்தேன் => கொடு
அவளுக்கென்று => அவள்
மனம் => மனம்
நம்பிக்கைக்குரிய => நம்பிக்கைக்குரி
நிலையை => நிலை
பலப்படுத்தியது => பலப்படுத்தி
கலவையானது => கலவை
நடுப்பகுதியிலிருந்து => நடுப்பகுதியில்
வெற்றிபெற்றது => வெற்றிபெற்ற
அமைப்பாளர்கள் => அமைப்பாளர்
பாவா => பாவா
மரடலு => மரடலு
பூஜா => பூஜா
பாலம் => பாலம்
பங்காரு => பங்காரு
பஞ்சாரம் => பஞ்சாரம்
ஜனகியின் => ஜனகி
பிரபலமாக => பிரபலம்
வெற்றிகளைக் => வெற்றி
பாப்பி => பாப்
லஹிரி => லஹிரி
ஸ்டுடியோவுக்குச் => ஸ்டுடியோ
சென்றபோது => சென்றபோ
​​தமிழ் => ​​தமிழ்
பாடலால் => பாடல்
ஈர்க்கப்பட்டார் => ஈர்
பெற => பெற
பாலிவுட்டுக்கு => பாலிவுடு
குமாருடன் => கு
ஒடியாவில் => ஒடி
பசுமையான => பசுமை
ஒடியா => ஒடி
இன்றும் => இல்
ஒரிசா => ஒரி
ஒன்றையும் => ஒல்
மொழிகளிலும் => மொழி
சிங்கள => சிங்கள
துலு => துலு
சமஸ்கிருத => சமஸ்கிரு
ஆதுதா => ஆது
பென்னில் => பென்
ஜப்பானிய => ஜப்பானி
புத்து => பு
பாத்து => பா
ஜெர்மன் => ஜெர்மன்
சுயம்கிருஷியில் => சுயம்கிருஷி
பிராமணக் => பிராமண
ஆந்திராவின் => ஆந்திர்
குண்டூர் => குண்டூர்
பள்ளபட்லா => பள்ள
ராமமூர்த்தி => ராமமூர்த்தி
சத்யவதி => சத்யவதி
தம்பதிகளுக்கு => தம்பதிகள்
பாடத்தொடங்கி => பாடத்தொடங்கி
நாதசுர => நாதசுர
மேதை => மேதை
பைடிசாமி => பைடிசாமி
பயிற்சியைப் => பயிற்சி
இடம்பெயர்ந்த => இடம்பெயர்
விளையாட்டு => விளையாட்டு
ஆசை => ஆசை
பாழானது => பாழா
ஏனோ => ஏனோ
நாளே => நாளே
தெலுங்குப் => தெலும்
எம்எல்ஏ => எம்எல்ஏ
பட்டத்தில் => பட்டம்
நீயாசா => நீயா
அடியார் => அடி
கண்டசாலாவுடன் => கண்டசால்
இதைத் => இதை
கிட்டியது => கிட்டி
கொங்கணி => கொங்கணி
துளு => துளு
சௌராஷ்டிரம் => சௌராஷ்டிரம்
வங்காளம் => வங்காளம்
சமஸ்கிருதம் => சமஸ்கிருதம்
சிங்களம் => சிங்களம்
ஆயிரக்காணக்கான => ஆயிரக்காண
சென்றிருந்த => சென்றிரு
ஞான => ஞான
பக்திப்பாடல்களைத் => பக்திப்பாடல்
தாமே => தாமே
இசையமைத்துப் => இசையமை
மௌனப் => மௌன
போராட்டம் => போராட்டம்
இசையமைத்திருக்கிறார் => இசையமைத்திர்
சித்தூர் => சித்தூர்
ராமச்சந்திரபுரத்தில் => ராமச்சந்திரபுரம்
மன்மதராஜு => மன்மதராஜு
லட்சமம்மா => லட்சமம்
தந்தையை => தந்தை
இழந்த => இழ
ரேணுகாபுரத்துக்குச் => ரேணுகாபுர
குடியேறியது => குடியேறி
உயர்நிலைப்பள்ளிவரை => உயர்நிலைப்பள்ளி
படித்த => படி
கல்லூரிப்படிப்புக்காக => கல்லூரிப்படி
ல் => ்
பச்சையப்பா => ப
கல்லுரியில் => கல்லுரி
பிஏ => பிஏ
இலங்கையில் => இலங்கை
யாழ்ப்பாணத்தில் => யாழ்ப்பாணம்
புலம் => புலம்
பெயர்ந்து => பெயர்
கனடாவில் => கனடா
தொராண்டோவில் => தொராண்டோ
இலக்சிமி => இலக்சிமி
கனடாவின் => கனடா
மேடைகளில் => மேடை
பரத => பரத
நாட்டியக் => நாட்டி
தொறாண்டோ => தொறாண்
மேற்கத்தைய => மேற்கம்
செவ்வியலிசைத் => செவ்வியலிசை
பெற்றவர் => பெற்ற
முதுகலைக் => முதுகல்
கல்வியை => கல்
தொடர்கின்றார் => தொடர்
அண்ணாமலைப் => அண்ணாமல்
பல்கலைக்கழகத்தின் => பல்கலைக்கழகம்
கனடாக் => கனடா
கிளையில் => கிளை
படித்து => படி
ஐபிசி => ஐபிசி
இன்னிசைக் => இன்னிசை
ஆத்திரேலியாவில் => ஆத்திரேலி
சிட்னி => சிட்னி
இலங்கைத் => இலம்
யாழ்ப்பாணத்தைச் => யாழ்ப்பாணம்
சந்தோஷ் => சந்தோஷ்
நாராயணனை => நாராயண
மறுமணம் => மறுமணம்
சுதீக்ஷன் => சுதீக்ஷன்
கல்வியின் => கல்
ஆல்பங்களான => ஆல்பங்கள்
பீட்சா => பீ
வில்லா => வில்
குக்கூ => குக்கூ
அறிமுகப்படுத்திக்கொண்டார் => அறிமுகப்படுத்திக்கொண்
இடைவேளைக்கு => இடைவேளை
ஆம் => ஆம்
சக்திஸ்ரீ => சக்திஸ்ரி
கோபாலன் => கோபாலன்
இணைத்து => இணை
பாடகிக்கான => பாடகி
விருதுகளுக்கு => விருதுகள்
கொங்கரா => கொங்கர்
இறுதிச்சுற்று => இறுதிச்சுற்று
குத்துச் => கு
விளையாட்டை => விளையாடு
மையமாக => மையம்
வைத்து => வை
சண்டைக்காரா => சண்டை
உசுரு => உசுரு
நாரம்பேலி => நாரம்பேலி
திரைப்படங்களான => திரைப்படங்கள்
இறைவி => இறை
மேயாத => மேயா
மான் => மான்
காலா => காலா
ஆம் => ஆம்
மறுதயாரிப்பான => மறுதயாரி
திரைப்படத்திலும் => திரைப்படம்
இதுவே => இது
பாடலாகும் => பாடல்
பிரபலாமானது => பிரபல்
மாரி => மாரி
ரவுடி => ரவுடி
பேபி => பேபி
தனுஷால் => தனுஷ்
எழுதப்பட்டு => எழுத
அவருடன் => அவர்
சமூக => சமூக
வலைத்தளங்களில் => வலைத்தளம்
அதிகஅளவு => அதிகஅளவு
மக்களால் => மக்
பார்க்கப்பட்ட => பார்
இதுவும் => இது
ஒன்று => ஒன்று
நேர்கொண்ட => நேர்கொண்ட
பார்வை => பார்
வானில் => வான்
இருள் => இர்
பாடியுளளார் => பாடியுளள்
சூரரைப் => சூரர்
போற்று => போற்று
வணிகக்கப்பற் => வணிக
படையிலிருந்து => படையில்
தலைமை => தலைம்
பொறியாளரான => பொறியாளர்
என்பவரவார் => என்பவர
ஹேமலதா => ஹேமல
வீணை => வீணை
நிபுணராவார் => நிபுணர்
சாருலதா => சாருல
முதுநிலை => முதுநில்
சங்கரா => சங்கர்
வித்யாஷ்ரமம் => வித்யாஷ்ரமம்
குமாரராணி => குமாரராணி
முத்தையா => மும்
அறிவியல் => அறி
கணினி => கணினி
பயன்பாடுகளில் => பயன்பாடு
சென்னைப் => சென்
மனித => மனித
சிறப்பிற்கான => சிறப்பில்
யோகாவில் => யோகா
வாசிப்பார் => வாசி
படித்துள்ளார் => படித்துள்
மென்பொருள் => மென்பொர்
அஸ்வின் => அஸ்
விஸ்வநாதனை => விஸ்
திருமணத்தை => திருமணம்
தொழில்துறையின் => தொழில்துறை
பிரபலங்கள் => பிரபலம்
பாலசந்தரும் => பாலசந்தர்
அடங்குவார் => அடம்
இரண்டரை => இரண்டர்
பொது => பொது
வெளிப்பாட்டைக் => வெளிப்பாடு
சோல்ஜர் => சோல்ஜர்
சோல்ஜர் => சோல்ஜர்
யுனெஸ்கோ => யுனெஸ்
கிளப் => கிள
ரெபல்லே => ரெ
ஏபி => ஏபி
பதக்கத்தையும் => பதக்கம்
ரோட்டரி => ரோட்டரி
பதக்கத்தை => பதக்கம்
குரலிசைத் => குரலிசை
தொகுப்பான => தொகு
ஐ => ஐ
லவ் => லவ்
மை => மை
இந்தியா => தியா
லிம்கா => லிம்
புக் => ப்
வேர்ல்ட் => வேர்
ரெக்கார்ட்ஸில் => ரெக்கார்ட்ஸ்
பாரதீய => பாரதி
கவுரவ் => கவுர
புராஸ்கர் => புராஸ்கர்
பட்டத்தை => பட்டம்
சவுபர்னிகா => சவுபர்னி
தீரம் => தீரம்
ஸ்கிரீன் => ஸ்கிரீன்
தலசேரி => தலசேரி
த்ரிஷ்ய => த்ரிஷ்
காலாவின் => காலா
ஏடி => ஏடி
உம்மர் => மர்
வயதை => வயதை
எட்டுவதற்கு => எட்டு
இற்கும் => இல்
இவரால் => இவர்
முடியும் => முடி
பருவம் => பருவம்
முன்னதாக => முன்
தொலைக்காட்சியால் => தொலைக்காட்சி
நடத்தப்பட்டு => நட
பங்கேற்று => பங்கேற்று
வெற்றியாளராக => வெற்றியாளர்
முடிசூட்டப்பட்டார் => முடிசூட்ட
மம்மூட்டி => மம்மூட்டி
மலையான => மலை
மொழித் => மொழி
தி => தி
டிரெயின் => டிரெயின்
சிறகெங்கு => சிறகெங்கு
பாடியதன் => பாடியதன்
மிகப்பெரும் => மிகப்பெர்
இறுதிப்போட்டியில் => இறுதிப்போட்டி
ஸ்ரீனிவாஸால் => ஸ்ரீனிவாஸ்
அடையாளம் => அடையாளம்
காணப்பட்ட => காண
நிகழ்வாகும் => நிகழ்
சக்கரமுத்து => சக்கரமு
அடுகு => அடுகு
அடுகு => அடுகு
ரஞ்சித்திற்கு => ரஞ்சித்தி
இப்பாடலை => பாடல்
பாடகரான => பாடகர்
பாடலானது => பாடல்
ஆசையாய் => ஆசை
வருகின்ற => வரு
ஹே => ஹே
பாடலுக்கும் => பா
இசையமைத்திருந்தார் => இசையமைத்திரு
புகழைப் => புகழ்
பெற்றுத் => பெற்று
சப்போஸ் => சப்போஸ்
சுக்ரன் => சுக்ரன்
தாய்மொழியான => தாய்மொழி
இன்னொரு => இன்னொரு
பாட்டொன்னு => பாட்டொன்
பாடான் => பாடான்
கிலுக்கம் => கிலுக்கம்
கிலுகிலுக்க்கம் => கிலுகிலுக்க்கம்
கம்யம் => கம்யம்
எந்தவரகு => எந்தவரகு
வது => வ
விருதிற்கு => விருதி
ஐயப்பன் => ஐய
நமஸ்கார => நமஸ்கார
ஸ்லோகங்களை => ஸ்லோகம்
சரணம் => சரணம்
ஐயப்பா => ஐய
தொகுக்கப்பட்டது => தொ
பஞ்சமுகி => பஞ்சமுகி
குழுவிற்கு => குழுவி
இந்தியாவிலுள்ள => தியா
வகையான => வகை
இசைகளைக் => இசை
இடத்தில் => இடம்
தங்கியிருந்ததால் => தங்கியிரு
உள்ளூர் => உள்ளூர்
பங்கேற்க => பங்கே
நண்பரின் => நண்
ஹிந்துஸ்தானி => ஹிந்துஸ்தானி
கடலூர் => கடலூர்
சுப்பிரமணியன் => சுப்பிரமணியன்
கனகசிங்கம் => கனகசிங்கம்
திருச்சூர் => திருச்சூர்
ராமன்குட்டி => ராமன்குட்டி
சுவாமி => சுவாமி
சப்த => ச
ஸ்வரங்கள் => ஸ்வரங்கள்
வென்றதினால் => வென்ற
பிரபலமடைந்தார் => பிரபலமடை
நாட்டிய => நாட்டி
கலைஞரான => கலைஞர்
ரேஷ்மி => ரேஷ்மி
மேனனை => மேன
ரியா => ரியா
திருநெல்வேலி => திருநெல்வேலி
சங்கரன்கோவிலைச் => சங்கரன்கோவில்
பழனிச்சாமி => பழனிச்சாமி
எட்டாம் => எடு
வகுப்போடு => வகு
பாதியில் => பாதி
நிறுத்தி => நிறுத்தி
தந்தையுடன் => த
நெசவுத் => நெசவு
தொழிலில் => தொழில்
ஈடுபட்டுவந்தார் => ஈடுபட்டு
திருவுடையானுக்கு => திருவுடை
சங்கர => சங்கர
ஆவுடையம்மாள் => ஆவுடையம்
மனைவியும் => மனை
மகள்களும் => மகள்
விசைத்தறி => விசைத்தறி
தொழிலாளியாக => தொழிலாளி
ஓவியக்கலை => ஓவியக்கல்
கொண்டதால் => கொண்ட
தட்டிகளில் => தட்டி
எழுதிவந்தார் => எழுதி
ஆவது => ஆ
வர்த்தகர் => வர்த்தகர்
ரஹீம் => ரஹீம்
ரோஷன் => ரோஷன்
ஆம் => ஆம்
கோட்டூர்புரத்தில் => கோட்டூர்புரம்
வாழ்ந்து => வாழ்
ல் => ்
வக்பு => வக்பு
வாரியத் => வாரி
தென்காசி => தென்காசி
வள்ளிநாயகம் => வள்ளிநாயகம்
பிள்ளை => பிள்
ஆவுடை => ஆவ்
தம் => தம்
ஏழாவது => ஏழா
இராமலிங்க => இராமலிம்
ஆச்சாரி => ஆச்சாரி
பயிற்சியைத் => பயிற்சி
முழுமையான => முழுமை
கச்சேரியை => கச்சேரி
திரைப்படங்களிலும் => திரைப்படம்
வது => வ
பக்த => பக்த
சேதா => சேதா
கண்ணகி => கண்ணகி
சிறுமி => சிறுமி
கண்ணகியாக => கண்ணகி
வேளையில் => வேளை
பயிற்சியை => பயிற்சி
என்பவரிடமும் => என்ப
வைத்தியநாத => வைத்தி
பாகவதரிடமும் => பாகவதர்
கலவையாகும் => கலவை
ஹரிஸ் => ஹரிஸ்
ஜெயராஜால் => ஜெயராஜ்
எழுதப்பட்ட => எழுத
பெரும்பங்காற்றியுள்ளார் => பெரும்பங்காற்றியுள்
இசைத்தொகுப்புகளிலும் => இசைத்தொகுப்பு
பதினொரு => பதினொரு
கற்றுத் => கற்று
தேர்ந்தபின் => தேர்
எட்டாவதுவது => எடு
பாடங்கள் => பாடம்
தேர்வை => தேர்
பெற்றோரின் => பெற்றோர்
மகளாவார் => மகளா
புனித => புனி
ஏஞ்சல்ஸ் => ஏஞ்சல்ஸ்
கான்வெண்ட் => கான்வெண்
ஆல்பா => ஆல்
ஒமேகா => ஒமே
பயிற்சியினை => பயிற்சியி
வயதுமுதல் => வயதுமு
பாடத்தொடங்கினார் => பாடத்தொடங்கி
கான்வென்ட் => கான்வென்
வகுப்பில் => வகு
படிக்கும்போது => படிக்கும்போ
தூர்தர்ஷனுக்காக => தூர்தர்ஷன்
ஸ்டார்ஸ் => ஸ்டார்ஸ்
நிமிட => நிமிட
நிகழ்ச்சியாக => நிகழ்ச்சி
பிரையன் => பிரையன்
கிறிஸ்டின் => கிறிஸ்
குழுமத்தின் => குழுமம்
ஐந்தாவது => ஐ
ஜிங்கிளை => ஜிங்கிள்
தாயன்பன் => தாயன்
இசையமைப்பாளர்ஏ => இசையமைப்பாளர்ஏ
கண்டெடுக்கப்பட்டார் => கண்டெ
வெல்லவில்லை => வெல்ல
ஆருயிரே => ஆருயிர்
மயிலிறகே => மயிலிற
இசையமைப்பளர்களிடம் => இசையமைப்பளர்
த்வனி => த்வனி
என்றழைக்கப்படும் => என்றழை
மும்பையைச் => மும்பை
பாடகராவார் => பாடகர்
ரங் => ரம்
பசந்தி => பசந்தி
ரூபாரூ => ரூபாரூ
ம் => ம்
ராதா => ராதா
என்பவர்களுக்கு => என்பவர்கள்
மும்பை => மும்
மாதுங்காவில் => மா
சுயசிந்தனை => சுயசி
நிபுணத்துவ => நிபுண
வணிகம் => வணிகம்
பொருளாதாரத்திற்கான => பொருளாதாரத்தில்
வர்த்தகத்தில் => வர்த்தகம்
பட்டையக் => படு
கணக்காளராக => கணக்காளர்
தெலுங்குக் => தெல்
குடும்பத்தை => கு்
சாம்பமூர்த்தி => சாம்பமூர்த்தி
சகுந்தலம்மா => சகுந்தலம்
மகனாக => மகனா
மாகாணம் => மாகாணம்
நெல்லூர் => நெல்லூர்
கொணடம்பேட்டை => கொணடம்பேடு
இன்றைய => இல்
ஆந்திரா => ஆந்திர்
அரிகதை => அரிகதை
காலட்சேபக் => காலட்சே
பிறந்தவர்கள் => பிற
சகோதரர்களும் => சகோதரர்
சகோதரிகளும் => சகோதரி
இருக்கின்றனர் => இர்
இவர்களில் => இவர்
சரணும் => சரண்
தயாரிப்பாளரும் => தயாரிப்பாளர்
இளவயதிலேயே => இளவயதிலேய்
வளர்த்து => வளர்
கவனித்து => கவனி
கருவிகளை => கரு
வாசிக்கவும் => வாசி
ஆக => ஆக
நோக்கத்தோடு => நோக்கம்
அனந்தபூர் => அனந்தபூர்
மாணவனாக => மாண
குடற்காய்ச்சலால் => குடற்காய்ச்சல்
நிறுத்திவிட்டு => நிறுத்தி
போதே => போதே
பரிசுகளைப் => பரிசு
சென்னையை => சென்
பரிசைப் => பரிசை
இக்குழுவில் => குழு
அனிருத்தா => அனிரு
போன்றோர் => போன்றோர்
பங்குபற்றினர் => பங்குபற்றி
இவர்களோடு => இவர்
எஸ்பிபி => எஸ்பி
பாடுவதையும் => பாடுவதை
கோதண்டபாணி => கோதண்டபாணி
பங்குபெற்ற => பங்குபெற்ற
தேர்ந்தெடுக்கப்பட்டார் => தேர்ந்தெ
இசையமைப்பாளர்களை => இசையமைப்பாளர்
சந்திப்பதும் => சந்தி
கேட்பதுமாக => கே
போட்டி => போட்டி
நிலவே => நில
என்னிடம் => என்
நெருங்காதே => நெரும்
சமசுகிருதம் => சமசுகிருதம்
எழுதிக் => எழுதி
சண்முகசுந்தரிக்கு => சண்முகசுந்தரி
நட்சத்திரங்கள் => நட்சத்திரம்
இடம்பெறும் => இடம்பெ
தேர்வாக => தேர்
நாகராஜனால் => நாகராஜன்
கவனிக்கப்பட்டபோது => கவனிக்கப்பட்டபோ
முன்னேற்றத்தைப் => முன்னேற்றம்
அகத்தியர் => அகத்தியர்
தாயிற் => தாயி
கோயிலும் => கோய்
இல்லை => இல்லை
ராஜின் => ராஜ்
தாயாக => தாயா
நடிகையாக => நடிகை
கேரளத்தின் => கேரளம்
திருவனந்தபுரத்தில் => திருவனந்தபுரம்
கைதமுக்கில் => கைதம்
பிரதாபன் => பிர
லைலா => லைலா
இணையருக்கு => இணையர்
திருவனந்தபுரத்தின் => திருவனந்தபுரம்
துவக்கக் => துவ
கல்வியைப் => கல்
திருவனந்தபுரம் => திருவனந்தபுரம்
கிறிஸ்து => கிறிஸ்
நகர் => நகர்
பலகுரல் => பலகுர்
மார் => மார்
இவானியோஸ் => இவானியோஸ்
மாணவர் => மாண
சங்கத்தின் => சங்கம்
கலைக் => கலை
கழக => கழக
செயலாளராக => செயலாளர்
அக்கல்லூரியில் => கல்லூரி
நிறைவு => நிறைவு
தொலைக்காட்சியான => தொலைக்காட்சி
பின்னர்தான் => பின்
யோசித்தார் => யோசி
பயில => பயில
நான்காம் => நான்
பாதமுத்ரா => பாதமு
வாங்கித் => வாங்கி
தேவதாசி => தேவதாசி
பொன் => பொன்
வசந்தம் => வசந்தம்
சாயல் => சாய்
கடினமான => கடி
தீப்தி => தீப்தி
பிரசாத்தை => பிர
ஆகத்தில் => ஆகம்
தொகுப்பாளர் => தொகுப்பாளர்
கலைஞராவார் => கலைஞர்
மஹா => மஹா
யெதாபிதாங்கி => யெதாபிதாங்கி
வெளியிடப்படவில்லை => வெளியிடப்பட
பாலசந்தர் => பாலசந்தர்
கைலாசம் => கைலாசம்
விஜயன் => விஜயன்
ஊஞ்சல் => ஊஞ்
நடிக்க => நடி
அணுகினார் => அணுகி
ராடனின் => ராடன்
அண்ணாமலை => அண்ணாமல்
பொம்மைகள் => பொம்மை
அக்கா => கா
செல்லலு => செல்லலு
மஞ்சுநாத் => மஞ்சு
ஹுடுகிககி => ஹுடுகிககி
வெளியீடாகும் => வெளியீ
சரோஜா => சரோஜ்
குறித்து => குறி
ஜகபதி => ஜகபதி
பாபுவாக => பாபு
பாத்திரத்திற்கு => பாத்திரத்தி
ஏற்றது => ஏற்ற
அருமை => அருமை
வ => வ
குவாட்டர் => குவாட்டர்
கட்டிங் => கட்டிம்
சிவாவின் => சிவா
வருங்கால => வருங்கால
மைத்துனராக => மை
வானவராயன் => வானவராயன்
வல்லவராயன் => வல்லவராயன்
விழித்திரு => விழித்திரு
நிறுவனமான => நிறு
கேபிடல் => கேபி
ஃபிலிம் => ஃபிலிம்
ஒர்க்ஸை => ஒர்க்ஸ்
நிறுவினார் => நிறுவி
இவர்களின் => இவர்
உன்னைச் => உன்
சரணடைந்தேன் => சரணடை
சரணின் => சரண்
சமுத்திரகனியின் => சமுத்திரகனி
கதைகளைக் => கதை
படத்தைத் => படம்
செய்ததாக => செய்
ஜெயம் => ஜெயம்
மழை => மழை
வர்ஷத்தின் => வர்ஷம்
வரவேற்பைப் => வரவே
அறிமுக => அறிமு
போக்கு => போ
அமைக்கும் => அமை
படமாகக் => படமா
கருதப்பட்டது => கருத
புதியவர்களை => புதி
வகித்தது => வகி
வெற்றிகளில் => வெற்றி
ஒன்றாகும் => ஒல்
ஆறாவது => ஆறா
ஆரண்ய => ஆரண்
காண்டம் => காண்டம்
பாராட்டுகளுக்கு => பாராட்டுகள்
பிராந்திய => பிராந்தி
மத்திய => மத்தி
வாரியத்தால் => வாரியம்
வெட்டுக்களைப் => வெடு
எதிர்பார்த்த => எதிர்
ஆபிஸ் => ஆபிஸ்
அடையவில்லை => அடை
ஸ்வர்ணா => ஸ்
கமலை => கமலை
திருடன் => திர்
போலீஸ் => போலீஸ்
இயக்கியதாகும் => இயக்கி
தேவதை => தேவதை
பணியாற்ற => பணியாற்ற
ஐகானின் => ஐக்
இருப்பதைப் => இருப்பதை
என் => என்
அப்பாவைப் => பாவை
போலவே => போல
இருக்கிறது => இர்
இதேபோன்ற => இதேபோன்ற
பயன்படுத்த => பயன்
விரும்ப => விரும்
மாட்டார்கள் => மாடு
அப்பாவே => பாவே
பாடிக்கொண்டிருக்கும்போது => பாடிக்கொண்டிருக்கும்போ
​​இசையமைப்பாளர்களுக்கு => ​​இசையமைப்பாளர்கள்
என்னுடைய => என்
குளோன் => குளோன்
இசையமைப்பாளர்களான => இசையமைப்பாளர்கள்
கீரவணி => கீரவணி
நகிலா => ந
நகிலா => நகிலா
வருசம் => வருசம்
மெல்லக => மெல்லக
மன்மதுடு => மன்மதுடு
நீனு => நீனு
நீனுக => நீனு
லெய்ன் => லெய்ன்
சைலஜா => சைலஜா
ப்ளீஸ் => ப்ளீஸ்
சார் => சார்
மாஜா => மாஜ்
மாஜா => மாஜா
எனக்கு => என
உனக்கு => உன
நண்பன் => நண்
வாரணம் => வாரணம்
ஆயிரம் => ஆயிரம்
சாந்தி => சாந்தி
நான் => நான்
பாடல்களாகும் => பாடல்கள்
ராஜாவுக்காக => ராஜா
கல்யாணம் => கல்யாணம்
ஒலிப்பதிவில் => ஒலிப்பதி
வெள்ளைக்கொடி => வெள்ளைக்கொடி
ஆடுகளம் => ஆடுகளம்
தந்தையோடு => தந்தை
இதற்காக => இதல்
வென்றனர் => வென்ற
நிகழ்ச்சிகள் => நிகழ்ச்சி
பாடுவதைக் => பாடுவதை
காணலாம் => காணல்
பருவ => பரு
நண்பர்களான => நண்பர்கள்
அமைத்தனர் => அமை
உறுப்பினர்களாக => உறுப்பினர்கள்
இருந்தனர் => இரு
பிஜோயாவுடன் => பிஜோய்
விவாகரத்து => விவாகர
முடிந்தது => முடி
அபர்ணாவை => அபர்
பிற்பகுதியில் => பிற்பகுதி
எடை => எடை
இழப்புக்கு => இழ
ஆளானார் => ஆளா
ஊகங்களுக்கு => ஊகங்கள்
பதிலளிக்கும் => பதிலளி
விதமாக => விதம்
உடல்நல => உடல்நல
உணர்வுள்ளவருக்கு => உணர்வுள்ள
பதிலளிப்பதாக => பதிலளி
கோவிட் => கோவி
சுவாசக் => சுவாச
சாவித்திரி => சாவித்திரி
சரணுக்கு => சரண்
ஆசான் => ஆசான்
மெமோரியல் => மெமோரி
சிபிஎஸ்இ => சிபிஎஸ்இ
அஜித்குமாரும் => அஜி
அமெரிக்காவின் => அமெரி
நியூயார்க்கில் => நியூய்
பேஸ் => பேஸ்
நிர்வாகத்தில் => நிர்வாகம்
இடைநிலைக் => இடைநில்
தொழிலைத் => தொழில்
தேர்வுசெய்தார் => தேர்வுசெய்
ஆவதற்கு => ஆவத
பாடம் => பாடம்
ஹென்றி => ஹென்றி
குருவிலாவின் => குருவில்
பாடத்தையும் => பாடம்
பெண்ணாக => பெண்
பானி => பானி
கல்யாணின் => கல்யாண்
கொஞ்சம் => கொஞ்சம்
காப்பி => காப்
சத்ய => சத்
பிரகாசுடன் => பிர
ஆதி => ஆதி
தாகிரா => தாகிரா
ராஞ்சனாவின் => ராஞ்சன்
பதிப்பில் => பதி
கலாரசிகா => கலாரசிகா
கனாவே => கனா
கனாவே => கனாவே
கர்நாடகப் => கர்நாட
இதயத்திற்கு => இதயத்தி
நெருக்கமானது => நெருக்கமானது
விவரித்தார் => விவரி
ஹரிச்சரணுடன் => ஹரிச்சரண்
கங்காரு => கங்காரு
படப்பாடலுக்காக => படப்பாடல்
இசையில்ல் => இசை
பந்து => பந்
ஜஸ்டின் => ஜஸ்
பிரபாகர் => பிரபாகர்
மந்திரியில் => மந்திரிய்
எரானகுளத்தில் => எரானகுளம்
பார்வதி => பார்வதி
களின்திறைமைக்கு => திறைமை
சிறுவயதிலே => சிறு
எலூரில் => எலூர்
ஆன் => ஆன்
எர்ணாகுளம் => எர்ணாகுளம்
தெரசா => தெர
அபிராம் => அபிர்
செய்துகொண்டார் => செய்துகொண்
ஆர்யன் => ஆர்யன்
நிகழ்ச்சியான => நிகழ்ச்சி
டான்சன் => டான்சன்
மெலடிஸ் => மெலடிஸ்
நூற்றுக்கணக்கான => நூற்றுக்கண
நட்சத்திரங்களில் => நட்சத்திரம்
ஜெர்ரி => ஜெர்ரி
அமல்தேவ் => அமல்
சியாம் => சி
உசெப்பச்சன் => உசெப்பச்சன்
சீதார => சீதார
விஜயா => விஜய்
ஷரெட் => ஷரெ
ஜாசி => ஜாசி
கிஃப்ட் => கிஃ
அப்சல் => சல்
யூசாஃப் => யூசாஃ
ஸ்டீபன் => ஸ்டீ
தேவசி => தேவசி
ரோனி => ரோனி
ரபேல் => ரபேல்
க்கும்போட்டியான => போட்டி
தூர்தர்ஷனின் => தூர்தர்ஷன்
ஹம்சத்வானி => ஹம்சத்வானி
மிகப்பவும் => மிக
பிரபலமானர் => பிரபலம்
அஷ்வாரூடன் => அஷ்வாரூடன்
திரைப்படத்துறைக்கு => திரைப்படத்துறை
ஓர்குகா => ஓர்
வல்லப்பொஜம் => வல்லப்பொஜம்
திரைபபடத்திற்கு => திரைபபடத்தி
அமெரிக்கா => அமெரி
கனடா => கனடா
ஜெர்மனி => ஜெர்மனி
இராச்சியம் => இராச்சியம்
நாடுகளின் => நாடு
ஜமீலாவை => ஜமீல்
ஷாகிர் => ஷாகிர்
குமரன் => குமரன்
ரஜினி => ரஜினி
ரசிகன் => ரசிகன்
அறிமுகமாகியுள்ளனர் => அறிமுகமாகியுள்ள
ஓரிரு => ஓரிரு
மெஹ்தி => மெஹ்தி
கஜல்களைக் => கஜல்
கேட்பதை => கேட்பதை
விரும்புகிறார் => விரும்பு
அமரனின் => அமரன்
சகோதரரும் => சகோதரர்
பெரியப்பா => பெரி
இயக்கமான => இயக்கம்
தயாரிப்பாளரான => தயாரிப்பாளர்
பேட் => பே
சரசாவின் => சரசா
ராஜலட்சுமியை => ராஜலட்சுமி
சிவானி => சிவானி
ஏற்கனவே => ஏற்க
தைய் => தை
ஆல்பத்திற்காக => ஆல்பத்தில்
திரும்பியதைத் => திரும்பியதை
தொடர்ந்து => தொடர்ந்து
பிரபுதனது => பிரபு
உறவினர்களான => உறவினர்கள்
ஆகியோரால் => ஆகியோர்
டெமோக்களுக்காகப் => டெமோக்கள்
பால்ய => பால்
அமைக்க => அமை
பங்கேற்றிருந்த => பங்கேற்றிரு
அறிவித்தனர் => அறிவி
பூஞ்சோலை => பூஞ்சோல்
என்றபடத்தில் => என்றபடம்
சங்கீதாவுக்கு => சங்கீ
ஜோடியாக => ஜோடி
இயக்கியது => இயக்கி
ரத்து => ரத்
படத்தை => படம்
புதுப்பித்து => புது
வெளியிடுவதற்கான => வெளியிடுவதல்
முயற்சிகள் => முயற்சி
தோல்வியடைந்தன => தோல்வியடை
நண்பர்கள் => நண்
முயற்சிகளில் => முயற்சி
வான்டட் => வான்ட
அகத்தியன் => அகத்தியன்
ங்கள் => ங்
வெளியிடத் => வெளியிட
தவறுவது => தவறு
கட்டுரை => கட்டுர்
அணுகப்பட்டார் => அணுக
ஏறக்குறைய => ஏறக்குறை
கதாபாத்திர => கதாபாத்திர
குறிப்பிடத்தக்கவை => குறிப்பிட
லிங்குசாமி => லிங்குசாமி
பேரரசு => பேரரசு
பாத்திரத்தில் => பாத்திரம்
சிவகாசி => சிவகாசி
சீமான் => சீம்
வாழ்த்துகள் => வாழ்
மாதவனின் => மாத
வரவு => வரவு
தோற்றத்தில் => தோற்றம்
சமுத்திரக்கனி => சமுத்திரக்கனி
ஞாபகம் => ஞாபகம்
வருதே => வரு
கதாபாத்திரங்களில் => கதாபாத்திரம்
கலைமாமணி => கலைமாமணி
பிரதேச => பிரதேச
புரிந்ததற்காக => புரிந்ததல்
பல்கலைக்கழகத்தினாலும் => பல்கலைக்கழகம்
காமராசர் => காமராசர்
முனைவர் => முனை
பத்ம => பத்ம
பூஷண் => பூஷண்
விபூஷண் => விபூஷண்
இசைக்கான => இசை
சாகர => சாகர
சங்கமம் => சங்கமம்
இல் => இ்
பைரவி => பைர
இல் => இ்
ருத்ர => ருத்ர
பழஸிராஜா => பழஸிராஜ்
இல் => இ்
தாரை => தாரை
தப்பட்டை => தப்
இசைப்பேரறிஞர் => இசைப்பேரறிஞர்
வழங்கியது => வழங்கி
இசைச் => இசை
சங்கம் => சங்கம்
நேர => நேர
விருப்பமான => விரு
நடிகருக்கான => நடிகர்
ரன் => ரன்
பேரழகன் => பேரழகன்
விருது– => விருது–
உன்னருகே => உன்
நான்னிருந்தால் => நான்னிரு
பார்த்திபன் => பார்த்தி
கனவு => கனவு
பலவகை => பலவகை
சான்றாயர் => சான்றாயர்
எடிசன் => எடிசன்
கொடைக்கானல்பண்பலை => கொடைக்கானல்பண்பல்
ஜ => ஜ
எஃப் => எஃ
தில் => தில்
உன் => உன்
சமையலறையில் => சமையலறையில்
மின்சார => மின்சார
கனவு => கனவு
பூ => பூ
பூக்கும் => பூ
ஓசை => ஓசை
புதிய => புதி
முகம் => முகம்
நேற்று => நேற்று
மாற்றம் => மாற்றம்
என்னது => என்னது
ஜென்டில்மேன் => ஜென்டில்மேன்
என் => என்
தோட்டத்தில் => தோட்டத்தில்
பின்னனி => பின்னனி
பிலிம் => பிலிம்
கிரிட்டிக்ஸ் => கிரிட்டிக்ஸ்
சினிமா => சினிம்
தினகரன் => தினகரன்
ஆண்டுக்கான => ஆண்
ஸ்வராலையா => ஸ்வரால்
பத்மபூசண் => பத்மபூசண்
சூடாமணி => சூடாமணி
இந்திரா => திரா
சிவசைலம் => சிவசைலம்
அறக்கட்டளை => அறக்கட்டள்
கலாநிதி => கலாநிதி
பின்னணிப்பாடகர் => பின்னணிப்பாடகர்
இசையமைப்பாளருக்கான => இசையமைப்பாளர்
ரெயின்போ => ரெய்
சொல்ல => சொல்ல
தடவைகள் => தடவை
ஒன்றிற்கும் => ஒல்
பதினான்கு => பதி
ஆந்திர => ஆந்திர
தனக்கு => தன
கிடைக்கவிருந்த => கிடைக்கவிரு
ஏற்க => ஏற்க
மறுத்து => மறு
அனுபவத்திற்கு => அனுபவத்தி
தாமதமாக => தாமதம்
வந்துள்ளது => வந்துள்ள
௭ன => ௭ன
கூறிவிட்டார் => கூறிவிடு
பசந்திலிருந்து => பசந்தில்
ருபாரூ => ருபாரூ
திறமைக்கான => திறமை
பசந்தி => பசந்தி
ரூபாருவுக்கு => ரூபாரு
IIFA => IIFA
பரிந்துரைக்கப்பட்டார் => பரிந்துரை
முன்தினம் => முன்தி
பார்த்தேனே => பார்த்தேனே
ஹப் => ஹப்
அறிமுகத்திற்கான => அறிமுகத்தில்
பாடகிக்கு => பாடகி
சவுத் => சவு
ஸ்கோப் => ஸ்கோ
பசங்க => பசம்
வெட்கம் => வெட்கம்
வருதே => வருதே
யூனிநார் => யூனி
மிர்ச்சி => மிர்ச்சி
ஆரஞ்சு => ஆரஞ்சு
படத்திலிலிருந்து => படத்திலில்
நேனு => நேனு
நூவன்ட்டே => நூவன்ட்டே
பூசண் => பூசண்
விபூசண் => விபூசண்
சாகித்திய => சாகித்தி
கலாசிகாமணி => கலாசிகாமணி
ஃபைன் => ஃபைன்
சொசைட்டி => சொசைட்டி
விரும்பத்தக்க => விரும்
பத்மஸ்ரீ => பத்மஸ்ரி
விபூஷன் => விபூஷன்
அரசால் => அர
வங்க => வங்க
ஆந்திரப் => ஆந்திர
பிரதேசம் => பிரதேசம்
கவுரவ => கவுர
டாக்டரேட் => டாக்டர்
பல்கலைக்கழகம் => பல்கலைக்கழகம்
எம்ஜி => ஜி
ஆனந்தலோக் => ஆன
பாடகருக்கு => பாடகர்
சங்கீதா => சங்கி
கலசிகாமணி => கலசிகாமணி
பத்மபுஷன் => பத்மபுஷன்
சரோஜாதேவி => சரோஜாதே
பவன் => பவன்
ராஜயுத்சவா => ராஜயுத்ச
ராமாச்சாரி => ராமாச்சாரி
நம்முரா => நம்முர்
யுவராணி => யுவராணி
ஸ்வரலயா => ஸ்வரலய்
கலைஞர்களுக்கு => கலைஞர்கள்
நடிப்பை => நடி
அங்கீகரிக்கும் => கீகரி
திருவனந்தபுரத்தை => திருவனந்தபுரம்
மையமாகக் => மையம்
கைராலி => கைராலி
சேனலையும் => சேனல்
ஊக்குவிக்கும் => ஊக்
அமைப்பால் => அமை
வழங்கப்படுகிறது => வழம்
வழங்கப்படுகின்றன => வழம்
காந்தர்வ => காந்தர்
சந்தியாவில் => சந்தி
வழங்குகிறார் => வழம்
கம்பன் => கம்
கொழும்புக் => கொழ்
பையின் => பை
வரலாறு => வரலாறு
பைக்கு => பை
தமிழ்மொழித் => தமிழ்மொழி
திரைப்பாடலுக்காக => திரைப்பாடல்
ஆசுகார் => ஆச்
முன்தெரிவு => முன்தெரிவு
ஆக்ரமனம் => ஆக்ரம
சே => சே
சைய்யா => சை
சைய்யா => சைய்யா
சலிம் => சலிம்
சுலைமான் => சுலைம்
நே => நே
பானா => பானா
ஜோடி => ஜோடி
ஹாலே => ஹ்
ஹாலே => ஹாலே
பாடலுக்காகவும் => பாடல்
ஹைதர் => ஹைதர்
பாடியதற்காக => பாடியதல்
கலைஞருக்கான => கலைஞர்
கபூலிவாலா => கபூலி
வினீத் => வினீ
கலைமாமணி => கலைமாமணி
அரசிடமிருந்து => அரசிடம்
சின்னதம்பியின் => சின்னதம்
தூளியிலே => தூளியிலே
விருதும் => விரு
பின்னணிக்கான => பின்னணி
ருகு => ருகு
ருக்மிணி => ருக்மிணி
பெல்லி => பெல்லி
சங்கங்களால் => சங்கம்
வழங்கப்பட்டுள்ளது => வழங்கப்பட்டுள்ள
ஏபிஎன்ஏ => ஏபிஎன்ஏ
அட்லாண்டாவிலிருந்து => அட்லாண்டாவில்
தங்க => தங்க
வளையல் => வளை
கானா => க்
சாம்ராட் => சாம்ராட்
ஆகியவற்றைப் => ஆகி
முதல்வரிடமிருந்து => முதல்வரிடம்
பயிரி => பயிரி
பியா => பியா
தேவதாஸ் => தேவதாஸ்
தீரா => த்
ஜ்ல்னா => ஜ்ல்னா
பஹேலி => பஹேலி
யேஹ் => யேஹ்
இஸ்க் => இஸ்
ஹாயே => ஹாயே
ஜப் => ஜப்
வீ => வீ
மெட் => மெ
ஜீவி => ஜீ
ரங்காலா => ரங்காலா
ஜோக்வா => ஜோ
பெராரி => பெராரி
மான் => மான்
அந்தஹீன் => தஹீன்
பெங்காலி => பெங்காலி
ஃபிலிம்பேரில் => ஃபிலிம்பேர்
புதுமுக => புதுமு
இசைத்துறையினருக்கான => இசைத்துறையி
கவிதா => கவி
சுப்ரமனியத்துடன் => சுப்ரமனி
கொள்ளப்பட்டது => கொள்ள
டோலா => டோ்
ஜாடு => ஜாடு
நாஷா => நாஷா
ஹே => ஹே
ஜிஸ்ம் => ஜிஸ்
பார்ஷோ => பார்ஷ்
தேரி => தேரி
ஒன் => ஒன்
இஸ் => இஸ்
கிங் => கிம்
அகர் => அகர்
தும் => தும்
மில் => மில்
ஜாவோ => ஜாவோ
ஜேஹர் => ஜேஹர்
பியு => பியு
போலே => போலே
பரிநீதா => பரிநி
பல் => பல்
ஹர் => ஹர்
பல் => பல்
லகே => லகே
ரஹோ => ரஹோ
முன்னா => முன்
ஜூபி => ஜூ
டூபி => டூபி
இடியட்ஸ் => இடியட்ஸ்
பகாரா => பகாரா
ஹேட் => ஹே
ஸ்டோரீஸ் => ஸ்டோரீஸ்
நூர் => நூர்
குதா => குதா
நேம் => நேம்
மேரி => மேரி
பாடிகார்டு => பாடிகார்டு
சைபோ => சைபோ
ஷோர் => ஷோர்
சிட்டி => சிட்டி
முன்பேநின்ன => நின்
நோடலெந்து => நோடலெந்து
முஸ்ஸான்ஜீமாட்டு => முஸ்ஸான்ஜீமாட்டு
கிழக்கு => கிழ
பூக்கும் => பூக்கும்
அன்வர் => அன்
உன் => உன்
பேரை => பேரை
சொல்லும் => சொல்லும்
அங்காடித் => காடி
தெரு => தெரு
ஆகாஷ => ஆகாஷ
பூமி => பூமி
மொக்கினா => மொ
மனசாலி => மனசாலி
மொக்கினா => மொ
மனசு => மனசு
தேன் => த்
தேன் => தேன்
குருவி => குரு
மெருப்புலா => மெருப்புலா
சிந்தக்காயல => சிந்தக்காயல
வெட்கம் => வெட்கம்
ஹூவின => ஹூவி
பனதாந்தே => பனதாந்தே
பிருகாலி => பிருகாலி
யேனு => யேனு
ஹெலபேக்கு => ஹெலபேக்கு
ஜோதியலி => ஜோதியலி
சந்து => ச
தொட்டில்லே => தொட்டில்லே
பனராஸ் => பனராஸ்
இரடு => இரடு
ஜேடேயன்னு => ஜேடேயன்னு
ஜாக்கி => ஜாக்கி
யேலொ => யேலொ
ஜிங்கிருவா => ஜிங்கிருவா
ஜஸ்ட் => ஜஸ்
மத் => மத்
மதல்லி => மதல்லி
மஞ்சு => மஞ்சு
மழ => மழ
காட்டில் => காட்டில்
ஆகந்தம் => ஆகந்தம்
எப் => எப்
தோடே => தோ
பத்மாஷ் => பத்மாஷ்
சாரியா => சாரி
மேரே => மேர்
தோல்னா => தோல்னா
பூல் => பூல்
புலையா => புலை
சினி => சினி
சோ => சோ
ஜாவுன் => ஜாவுன்
மைன் => மைன்
வோ => வோ
லம்ஹே => லம்ஹ்
ஊ => ஊ
டர்ட்டி => டர்ட்டி
பிக்சர் => பிக்சர்
ஸ்டார் => ஸ்
ஓம்காரா => ஓம்
தோட்டில்லே => தோட்டில்லே
பனாரஸ் => பனாரஸ்
அப்ஸரா => ஸரா
துஜ் => துஜ்
மேன் => மேன்
ரப் => ரப்
திக்தா => தி
பனாதீ => பனாதி
ஆஹிஸ்தா => ஆஹிஸ்
ஆஹிஸ்தா => ஆஹிஸ்தா
பச்னா => பச்
ஹசேனோ => ஹச்
ஆஜ் => ஆஜ்
தில் => தில்
ப்ளூ => ப்ளூ
குளோபல் => குளோ
ஓம் => ஓம்
காரா => காரா
மஞ்சுமழா => மஞ்சுமழா
ஆகதன் => ஆகதன்
ப்ரனாயம் => ப்ரனாயம்
ரதிநிர்வேதம் => ரதிநிர்வேதம்
சான்சுயீ => சான்சுயி
டஸ்ட் => டஸ்
புது => புது
கிளர்ச்சி => கிளர்ச்சி
டெலி => டெலி
லைப் => லை
தொடருக்காக => தொடர்
ஆன்ந்தலோக் => ஆன்
புரஸ்கார் => புரஸ்
மாணிக் => மாணி
பங்க்ளா => பங்
வங்காள => வங்காள
நிருபர்கள் => நிரு
கூட்டமைப்பு => கூட்டமைப்பு
சுபோ => சுபோ
திருஷ்டி => திருஷ்டி
விளங்கியதற்காக => விளங்கியதல்
அச்தித்வா => தி
நகுவா => நகு
மொதலனீ => மொதலனீ
மனசாரி => மனசாரி
பிக் => பி
கல்ப் => கல்
அனுராகவிலோச்சனன்னயி => அனுராகவிலோச்சனன்னயி
நீலத்தாமரா => நீலத்தாமர்
அனந்தோ => அன
சேரா => சேரா
மன்னிப்பாயா => மன்னிப்பாயா
சுவராலாய => சு
ஏசுதாஸ் => ஏசுதாஸ்
விருது => விருது
மா => மா
ச்சலி => ச்சலி
ச்சலிகா => ச்சலிகா
மிஸ்டர் => மிஸ்டர்
பெர்பெக்ட் => பெர்பெ
சீதா => சீ
சீமந்தம் => சீமந்தம்
சிறீ => சிறீ
ராம => ராம
ராஜ்யம் => ராஜ்யம்
சிறந்தப் => சிற
ஆம் => ஆம்
ஆதார் => ஆத்
சுனா => சுனா
எட்டி => எட்டி
காராத் => காரா
மகாராட்டிரா => மகாராட்டிர்
நிகேதன் => நிகேதன்
ரஜினி => ரஜினி
மேல => மேல
கண்ணு => கண்ணு
வது => வ
நடிகமணி => நடிகமணி
சுத்தானந்த => சு
பாரதியார் => பாரதி
பண்பாட்டுத் => பண்பாட்டு
துறையின் => துறை
இயல் => இயல்
மன்றம் => மன்றம்
சார்பில் => சார்
நடத்தப்பட்ட => நட
காலகட்டத்திற்காக => காலகட்டத்தில்
ஆண்டுக்கு => ஆண்
குரலிசை => குரலிசை
பிரிவின் => பிரி
செல்வம் => செல்வம்
முத்தமிழ் => முத்தமிழ்
பேரவை => பேர
பேரொலி => பேரொலி
நியூயார்க் => நியூய்
தமிழ்ச் => தமிழ்
தனிக் => தனி
மாரிலேடன் => மாரிலேடன்
அமெரிக்கா => அமெரிக்கா
விருதுகளையும் => விருது
பெற்றுள்ள => பெ
பின்னணிப்பாடகி => பின்னணிப்பாடகி
ஆம் => ஆம்
துவங்கி => துவங்கி
பதினைந்து => பதி
சேர்த்துள்ளார் => சேர்த்துள்
கிடைத்திருக்கிறது => கிடைத்திர்
பாயாலேன் => பாயால்
சுன்முன் => சுன்
தென்னிந்தியப் => தென்னிந்தி
தேசீய => தேசீ
சிறப்பைப் => சிற
பூக்களுமே => பூக்
திருச்சிராப்பள்ளியில் => திருச்சிராப்பள்ளி
காலை => காலை
பிரார்த்தனைக்காக => பிர்
சிறுவர்கள் => சிறு
பாடுவதாகவும் => பாடு
பல்கலைக் => பல்கல்
கழகத்தில் => கழகம்
திட்டத்தில் => திட்டம்
இணைக்கப்பட்டுள்ளதாகச் => இணைக்கப்பட்டுள்ள
சொல்லப்படுகிறது => சொல்ல
பாடல்களுக்கு => பாடல்கள்
பாடகர்களுடனும் => பாடகர்
சாதனைகளின் => சாத
சிகரமாக => சிகரம்
ஆம் => ஆம்
ராஷ்டிரபதி => ராஷ்டிரபதி
ஆ => ஆ
கலாம் => கல்
அவர்களிடமிருந்து => அவர்களிடம்
பெற்றதைச் => பெற்றதை
சொல்லலாம் => சொல்லல்
புகைப்படக்காரர்களும் => புகைப்படக்காரர்
பத்திரிகைக்காரர்களும் => பத்திரிகைக்காரர்
நிமிடப் => நிமிட
பேட்டிக்காக => பேட்டி
வரிசையில் => வரிசை
காத்து => கா
நின்ற => நின்ற
சகோதரியின் => சகோதரி
ஷாரூக்கானின் => ஷாரூ
கையெழுத்தைப் => கையெழும்
பெறும் => பெ
முயற்சியில் => முயற்சி
எனக்குத் => என
தெரிந்ததெல்லாம் => தெரி
ஓரளவு => ஓரளவு
இசையே => இசை
எல்லாம் => எல்லாம்
நடித்தது => நடி
வர்ஷம் => வர்ஷம்
மெல்லாக => மெல்லாக
மழையில் => மழை
ஷைலஜா => ஷைலஜா
ஜில்லுனு => ஜில்லுனு
வாழ்த்துக்கள் => வாழ்
உன்மேல => உன்மேல
ஆசப்பட்டு => ஆச
விருதுகளுக்கான => விருதுகள்
நடுவர் => நடு
மன்ற => மன்ற
உறுப்பினர்களில் => உறுப்பி
ஜாக்ரான் => ஜா
அரசாங்கத்தின் => அரசாங்கம்
குடிமை => குடிம்
மகாராஷ்டிராவிலிருந்து => மகாராஷ்டிராவில்
துணிச்சல் => துணி
ஸ்வாபிமானி => ஸ்வாபிமானி
மும்பைக்கர் => மும்பைக்கர்
கவுரவிக்கப்பட்டார் => கவுரவி
சல்யூட் => சல்யூ
குமாரிடமிருந்து => குமாரிடம்
நினைவு => நினைவு
மும்பையில் => மும்பை
அம்பேத்கர் => பேத்கர்
பிஃபா => பிஃ
பெறப்பட்டது => பெற
சித்ரகுப்த => சித்ரகு
சினியாத்ரா => சினி
போஜ்புரி => போஜ்புரி
மகாராஷ்டிர => மகாராஷ்டிர
ரத்னா => ரத்
மெட்ஸ்கேப் => மெட்ஸ்
சினிமாவுக்கான => சினிம்
சினியாத்திர => சினியாத்திர
சம்மன் => சம்மன்
சாம்ராட் => சாம்
விக்ரமாதித்ய => விக்ரமாதி
அலங்காரன் => அலங்காரன்
காலாஷ்ரி => காலாஷ்ரி
இலிருந்து => இல்
வாழ்நாள் => வாழ்
சாதனையாளர் => சாதனையாளர்
சஹாரா => சஹ்
அவத் => அவ
சூரியதட்டா => சூரியதடு
காதலுக்கு => காதல்
திருப்பாச்சி => திருப்பாச்சி
கார்பரேட் => கார்
டுடே => டுடே
பொதுச்சேவை => பொதுச்சே
அறிவிப்பு => அறிவிப்பு
வெள்ளி => வெள்ளி
அம்ரிதா => ரிதா
மாத்ருபூமி => மாத்ருபூமி
அருவி => அரு
வேட்டைக்காரன் => வேட்டைக்காரன்
இசைஅருவி => இசைஅரு
துப்பாக்கி => துப்பாக்கி
முதல்வர் => முதல்
வழங்கிய => வழங்கி
ஸ்டாரின் => ஸ்
ஹர்தா => ஹர்
நாடோஜா => நாடோஜ்
ஹம்பி => ஹம்
ஆளுநரால் => ஆளுநர்
ருபாரூ => ருபாரூ
கௌரவிக்கப்பட்டார் => கௌரவி
ரசிகர்கள் => ரசிகர்
சங்க => சங்க
அறை => அறை
சுமு => சுமு
முருக => முரு
கானமிர்தம் => கானமிர்தம்
குயில் => குய்
திலகம் => திலகம்
இசையரசி => இசையரசி
நாதக்கனல் => நாதக்கன்
சிம்பிள் => சிம்பிள்
ஆகி => ஆகி
ஒந்து => ஒந்
ஸ்டோரி => ஸ்டோரி
கரகிடா => கரகி
பானினல்லி => பானினல்லி
சமே => சமே
வென் => வென்
டைம் => டைம்
ஸ்ட்ரைக்ஸ் => ஸ்ட்ரைக்ஸ்
லைலா => லைல்
லைலா => லைலா
ஸ்டார்டஸ்ட் => ஸ்டார்டஸ்
பாரத => பாரத
கலாசார => கலாசார
யுவகலா => யுவ
நல்வாழ்வு => நல்வாழ்வு
இன்னிசை => இன்னிசை
மாமணி => மாமணி
திருப்புகழ் => திருப்புகழ்
மன்றத்திலிருந்து => மன்றத்தில்
இன்னிசை => இன்னிசை
வாரிதி => வாரிதி
ராகம் => ராகம்
வசந்தகுமாரி => வசந்தகுமாரி
விருது => விருது
ஆன்மீகப் => ஆன்மீ
பேரவையிடமிருந்து => பேரவையிடம்
நவரச => நவரச
நாயகி => நாயகி
கலைமாமணி => கலைமாமணி
விருது => விருது
சங்கீத => சங்கீ
சிகாமணி => சிகாமணி
உகாதி => உகாதி
காங்கிரஸ் => காங்கிரஸ்
கானம்ருத => கானம்ரு
வாணி => வாணி
கார்த்திக் => கார்த்தி
நுண் => நுண்
மன்றத்தின் => மன்றம்
பேரொளி => பேரொளி
சத்யபாமா => சத்
மதிப்புறு => மதிப்புறு
பத்மா => பத்
நாத => நாத
கோவிந்தா => கோவி
ஹைதராபாத்தில் => ஹைதர்
விழாக்களில் => விழா
சங்கீத => சங்கீ
விருதுக்காக => விருதுக்காக
பெஸ்ட் => பெஸ்
கான்செர்ட் => கான்செர்
பெர்ஃபாமிங் => பெர்ஃபாமிம்
ஆர்டிஸ்ட் => ஆர்டிஸ்ட்
பத்ம => பத்ம
சாதனா => சாதனா
நாத => நாத
கோவிதா => கோவிதா
இசைக்கனல் => இசைக்கனல்
கானம்ரிதாகலாரசனா => கானம்ரிதாகலாரசனா
சுனதாவிநோதினி => சுனதாவிநோதினி
இசைக்கலைத் => இசைக்கல்
தாரகை => தாரகை
பட்டங்களையும் => பட்டம்
அகாதமி => அகாதமி
அமைப்பு => அமைப்பு
அகாதெமி => அகாதெமி
கலாசாரதி => கலாசாரதி
கந்தர்வ => கந்தர்
முதலமைச்சர் => முதலமைச்சர்
ஜெயலலிதாவால் => ஜெயலலி
வெள்ளிப் => வெள்ளி
செவாலியே => செவாலி
பிரான்ஸ் => பிரான்ஸ்
வெச்சிக்க => வெச்சி
வெச்சிகாவா => வெச்சிகாவா
கோயம்புத்தூரிலுள்ள => கோயம்புத்தூர்
தாமோதரன் => தாமோதரன்
மேலாண்மைக் => மேலாண்
யூத் => யூ
ஐகான் => ஐகான்
கலாக் => கலா
குழுவால் => குழு
வழங்கப்பட்ட => வழம்
அகாதாமியின் => அகாதாமி
பரிந்துரைகளில் => பரிந்துரை
திறமைகளை => திறமை
வளர்ப்பதற்காக => வளர்ப்பதல்
க்குப் => க்கு
பரிந்துரைகளுக்கு => பரிந்துரைகள்
பரிசீலிக்க => பரிசீலி
வேண்டாம் => வேண்
கேட்டார் => கேடு
சகோதரியைப் => சகோதரி
இனிமேல்விருது => இனிமேல்விருது
பரிந்துரைக்கு => பரிந்துரை
பெயரைக் => பெயர்
கேட்டுக்கொண்டார் => கேட்டுக்கொண்
இருந்தபோதிலும் => இருந்தபோ
அதிகமுறை => அதிகமுறை
வென்றவர்கள் => வென்ற
இணைந்துள்ளார் => இணைந்துள்
ரங்கீலாவுக்கான => ரங்கீல்
விருதுகளின் => விருது
பட்டியல் => பட்டி
பின்வருமாறு => பின்வருமாறு
கரிபோன் => கரிபோன்
சுனோ => சுனோ
தஸ் => தஸ்
லக் => லக்
பர்தே => பர்
மெயின் => மெய்
ரஹ்னே => ரஹ்
தோ => தோ
ஷிகார் => ஷி
பியா => பி
து => து
ஆஜா => ஆஜா
கேரவன் => கேர
மரோ => மரோ
ஹரே => ஹரே
ஹன் => ஹன்
லாகி => லாகி
ஹைன் => ஹைன்
நைனா => நைனா
செயின் => செய்
ஹம்கோ => ஹம்
கபி => கபி
பிரன் => பிரன்
ஜெயே => ஜெயே
பர் => பர்
வச்சன் => வச்சன்
யே => யே
மேரா => மேரா
சீஸ் => சீஸ்
உம்ராவ் => ரா
குச் => கு
சமன் => சமன்
இஜாசாத் => இஜா
ஐஃபா => ஐஃபா
கைசா => கைசா
அவற்றுள் => அவ
நைட்டிங்கேல் => நைட்டிங்கேல்
இந்தோ => தோ
பாக் => பா
அசோசியேஷனில் => அசோசியேஷன்
வீடியோகான் => வீடியோ
ஜானம் => ஜா
சமாஜா => சமாஜ்
கரோ => கரோ
ஆல்பத்திற்கு => ஆல்பத்தி
சம்ஜா => சம்ஜ்
தயாவதி => தயாவதி
மோடி => மோடி
மில்லினியத்தின் => மில்லினியம்
துபாய் => து
கோல்ட் => கோல்
தக்ஷக்கிலிருந்து => தக்ஷக்கில்
முஜே => முஜே
தேவுக்கு => தே
கம்பக்த் => கம்ப
இஷ்கிற்கு => இஷ்
இங்கிலாந்து => கிலா
டோனி => டோனி
பிளேர் => பிளேர்
கைஸே => கைஸே
ஜலே => ஜலே
ஹால் => ஹால்
ஃபேமுக்கான => ஃப்
சான்சூய் => சான்சூய்
சிறப்பான => சிற
பங்களிப்புகளுக்காக => பங்களிப்புகள்
தொழில்துறை => தொழில்துறை
கூட்டமைப்பின் => கூட்டமை
லிவிங் => லிவிம்
லெஜண்ட் => லெஜண்
இம்மீஸ் => மீஸ்
ஜானே => ஜானே
ஜித் => ஜி
கரோவின் => கரோ
சட்டம் => சட்டம்
ஸ்டைலிஷ் => ஸ்டைலிஷ்
குருஜாதா => குருஜ்
கிருஷ்ணாதஸ் => கிருஷ்ணாதஸ்
இசைகளை => இசை
மொழிகளான => மொழிகள்
இவரிடம் => இவர்
இணைந்திருந்த => இணைந்திரு
ஜிகேவி => ஜிகே
மனைவியான => மனைவி
கணவர் => கண
செருகளத்தூர் => செருகளத்தூர்
பொதுவாகவே => பொது
புராணக் => புராண
கதைகளுடன் => கதை
சம்பந்தப்பட்ட => சம்ப
அதிலும் => அத்
கிருஷ்ணர் => கிருஷ்ணர்
வேடத்தில் => வேடம்
ஆண்டுக் => ஆண்
காலங்களில் => காலம்
சாமாவின் => சாமா
சுவாமிநாதன் => சுவாமிநாதன்
மிராசுதாரராக => மிராசுதாரர்
வைத்தியநாதய்யர் => வைத்தியநாதய்யர்
என்பவருக்குப் => என்ப
விடவே => விட
தாய்மாமன் => தாய்மாமன்
தஞ்சைக்கு => தஞ்சை
அங்குள்ள => க்
கல்யாணசுந்தரம் => கல்யாணசுந்தரம்
சேர்த்தார் => சேர்
அத்துடன் => த்
சோதனையில் => சோத
சித்தி => சித்தி
புரிந்து => புரி
தேடும் => தே
பொருட்டு => பொருட்டு
தம்பியுடன் => தம்
கட்சியின் => கட்சி
அலுவலகத்தில் => அலுவலகம்
எழுத்தராக => எழுத்தர்
மாதங்கள் => மாதம்
காஸ்மாபாலிட்டன் => காஸ்மாபாலிட்டன்
கிளப்பில் => கிள
எழுத்தராகப் => எழுத்தர்
இங்கு => கு
ஹிஸ் => ஹிஸ்
மாஸ்டர்ஸ் => மாஸ்டர்ஸ்
நிறுவனத்தினர் => நிறுவனத்தி
இசைத்தட்டுகளில் => இசைத்தட்டு
மேக்கப்மேன் => மே
ஆகப் => ஆக
சாமாவை => சாமா
நேசனல் => நேசன்
மூவிடோன் => மூவிடோன்
ஸ்டூடியோவுக்கு => ஸ்டூடியோ
நாரதராக => நாரதர்
நாராயணனின் => நாராயணன்
ஓராண்டு => ஓராண்டு
திரௌபதி => திரௌபதி
வஸ்திராபகரணம் => வஸ்திராபகரணம்
கிருஷ்ணனாக => கிருஷ்ணன்
வேடமேற்று => வேடமேற்று
மாயா => மாயா
பஜார் => பஜ்
கருடகர்வ => கருடகர்
பங்கம் => பங்கம்
பாமா => பாமா
பரிணயம் => பரிணயம்
சிந்தாமணி => சிந்தாமணி
அடுத்தடுத்த => அடுத்தடு
வேடத்திலேயே => வேடத்திலேய்
தந்தன => த
அம்பிகாபதி => பிகாபதி
சூலை => சூலை
திரையிசைப் => திரையிசை
பாடியவர் => பாடி
மலைக் => மலை
கோட்டை => கோடு
மாநகரில் => மாநகர்
நகைத்தொழில் => நகைத்தொழ்
சுப்ரமணியன் => சுப்ரமணியன்
என்பவருக்கு => என்ப
எழுத்து => எழு
திருச்சிராப்பள்ளியைக் => திருச்சிராப்பள்ளி
குறிப்பதாகும் => குறி
ராமநாதன் => ராமநாதன்
விருப்பமாகப் => விரு
பாடுவார் => பாடு
இந்தியப் => திய
முக்கியமாக => முக்கியம்
இடம்பெற்றுள்ளன => இடம்பெற்றுள்ள
பெற்றுள்ளதுடன் => பெற்றுள்ள
பரிந்துரைக்கப்ப்ட்டதுடன் => பரிந்துரைக்கப்ப்ட்ட
பிறகும் => பிற
இடத்தினைப் => இடத்தி
போராட => போராட
யுனீஸ் => யுனீஸ்
பீஸ் => பீஸ்
இறுதியாக => இறுதி
அமீர் => அம்
ஜூஹி => ஜூஹி
சாவ்லா => சா
கயாமத் => கயாம
தக் => தக்
திறனை => திற
பாப்பா => பா
கெஹ்தே => கெஹ்
ஹைன் => ஹைன்
நிலைநிறுத்திக் => நிலைநிறுத்தி
வரலாற்றில் => வரலா
தசாப்தங்களுக்கும் => தசாப்தம்
மேலாக => மேலா
எனக் => என
குறிப்பிடப்படும் => குறிப்பிட
பெங்களூருவில் => பெங்களூரு
வசித்துவந்த => வசி
ஆண்டுகளின் => ஆண்டு
ரஹ்மானுடன் => ரஹ்
பரவலாகப் => பரவல்
தொகுப்பாளராகவும் => தொகுப்பாளர்
பிற்பகுதியிலிருந்து => பிற்பகுதியில்
களின்விளக்கப்படங்களில் => விளக்கப்படம்
க்கும்காலத்தின் => காலம்
கத்தோடு => கம்
கதோரம் => கதோரம்
தேவதூதர் => தேவதூதர்
பாடி => பாடி
கதோரம் => கதோரம்
பூ => பூ
வேனம் => வே
பூப்பாத => பூ
வேனம் => வேனம்
மின்னாமினுங்கின்டே => மின்னாமினும்
நூருங்குவெட்டம் => நூருங்குவெட்டம்
தரும் => தர்
தலிரும் => தலிரும்
சிலம்பு => சிலம்பு
ஆகியன => ஆகி
பிரபோத் => பிர
காலகட்டங்களில் => காலகட்டம்
விருப்பப்பட்ட => விரு
வாழ்நாளில் => வாழ்
கூடுதலாக => கூடுதல்
தாதாசாஹெப் => தாதாசாஹெ
பால்கே => பால்
பூர்ண => பூர்ண
மகாமாயா => மக்
தம்பதியினருக்கு => தம்பதியி
உடன்பிறப்பான => உடன்பிற
இசையாசிரியர் => இசையாசிரியர்
தேயின் => தேய்
தாக்கத்தால் => தாக்கம்
இசையின்பால் => இசையின்
ஆர்வமிக்கவரானார் => ஆர்வமி
பாபர் => பா
பாடசாலையில் => பாடசாலை
கல்வியும் => கல்
ஸ்காட்டிஷ் => ஸ்காட்டிஷ்
சர்ச் => சர்
பள்ளியிலும் => பள்ளி
உயர்கல்வியும் => உயர்கல்
உசுதாது => உசுதாது
தாபீர் => தா
இவர்களிடம் => இவர்
கல்லூரிகளுக்கிடையேயான => கல்லூரிகளுக்கிடையேய்
இசைப்போட்டிகளில் => இசைப்போட்டி
பரிசுகள் => பரிசு
இசையமைப்பாளரும் => இசையமைப்பாளர்
மறுமலர்ச்சி => மறுமலர்ச்சி
மகாகவி => மகாக
பேரனாவார் => பேரன்
நடிகைகளுக்காக => நடிகைகள்
இதுவரையிலும் => இதுவரை
ப் => ப்
ஏஷ்யாநெட் => ஏஷ்யாநெ
பாட்டுப் => பாட்டு
போட்டியின் => போட்டி
சீசனில் => சீசன்
நிறுவிக் => நிறு
பிற்பகுதியிலும் => பிற்பகுதி
முற்பகுதியிலும் => முற்பகுதி
விரிவாகப் => விரி
இல் => இ்
இல் => இ்
பசவனகுடி => பசவனகுடி
தேசியக் => தேசி
அறிவியலில் => அறிவியல்
தொலைபேசித் => தொலைபேசி
இல் => இ்
நிர்வாக => நிர்
பொறியாளராக => பொறியாளர்
தேவகிரி => தேவகிரி
ஜோஷியின் => ஜோஷி
சீடராக => சீடர்
நரசிம்மசுவாமியின் => நரசிம்மசுவாமி
படைப்பான => படை
மைசூரு => மைசூரு
மல்லிகேவிற்கான => மல்லிகேவில்
இசையமைப்பும் => இசையம்
துறவி => துற
சிசுநாள => சிசுநாள
ஷரீப்பின் => ஷரீ
படைப்புகளுக்கான => படைப்புகள்
வைத்தியநாதன் => வைத்தியநாதன்
ககானா => கக்
கோட் => கோ
இசைப்பதிவின் => இசைப்பதி
அஸ்வத்தை => அஸ்வம்
சந்திப்பு => சந்திப்பு
தசாப்தங்களாக => தசாப்தங்கள்
வலுவான => வலு
உறவுக்கு => உற
இட்டுச் => இட்டு
அஸ்வத்தின் => அஸ்வம்
இசையமைப்புகளுக்கு => இசையமைப்புகள்
வைத்தி => வைத்தி
யெனே => யெனே
பராலி => பராலி
ப்ரீத்தி => ப்ரீத்தி
இராலி => இராலி
படத்தில்தான் => படத்தில்
இரட்டையர்கள் => இரட்டையர்
ஒத்துழைப்பாளர்களாக => ஒத்துழைப்பாளர்கள்
மாறினர் => மாறி
சுயாதீனமாக => சுயாதீ
சின்னாரி => சின்னாரி
முத்தா => மு
ஷரீப் => ஷரீ
மைசூரா => மைசூர்
மல்லிகே => மல்லி
கோத்ரேஷி => கோத்ரேஷி
கனசு => கனசு
நாகமண்டலா => நாகமண்
சுகமா => சுகம்
சங்கீதத்தின் => சங்கீதத்தின்
முன்னோடியாக => முன்னோடி
பல்துறை => பல்துறை
இசைத்தொகுப்புகளை => இசைத்தொகுப்பு
பெயரால் => பெயர்
அறியப்படும் => அறி
இசைவகையில் => இசைவகை
பாடலாசிரியராகவும் => பாடலாசிரியர்
விளங்குகிறார் => விளம்
கலியுகம் => கலியுகம்
அஜலா => அஜலா
உஜலா => உஜலா
தமிழகத்தைச் => தமிழகம்
பாடகியாகவும் => பாடகி
செயல்படுகிறார் => செயல்
சனவரி => சனவரி
iஇல் => iஇ்
வாரங்களுக்கு => வாரங்கள்
பிடித்து => பிடி
பிரிவிலும் => பிரி
ஒருசில => ஒருசில
சௌமியா => சௌமி
இசைட்தொகுப்பை => இசைட்தொகு
அவர்தனது => அவர்
பதின்மூன்றாம் => பதின்மூல்
தொகுப்புகளுக்கான => தொகுப்புகள்
ஷாலின் => ஷால்
பதிவர் => பதி
எழுத்தாளர் => எழுத்தாளர்
தின்செல் => தின்செல்
ரங்கி => ரங்கி
ஆதித்யா => ஆதி
வசிக்கிறார் => வசி
ஸ்வீடன் => ஸ்வீடன்
மேலாளராகப் => மேலாளர்
இஸ்மாயீல் => இஸ்மாயீல்
முஹம்மத் => முஹம்ம
அரசியல்வாதி => அரசியல்வாதி
இஸ்லாமியப் => இஸ்லாமி
திராவிடக் => திரா
கொள்கையில் => கொள்கை
பற்றுக் => ப
கழகத்தின் => கழகம்
வகித்தார் => வகி
இசை => இசை
முரசு => முரசு
ஒர் => ஒர்
பாடலாசிரியரும் => பாடலாசிரியர்
நிகழ்கலை => நிகழ்கல்
நிகழ்த்துனராகவும் => நிகழ்
பஞ்சாபியைத் => பஞ்
தாய்மொழியாகக் => தாய்மொழி
கொண்டவர் => கொண்ட
பள்ளிப் => பள்ளி
படிப்பையும் => படி
மேற்படிப்பையும் => மேற்படி
தில்லியிலேயே => தில்லியிலேய்
எப்பொழுதும் => பொழு
பற்றியும்கலையைப் => கலை
சிந்தனையைக் => சி
பாப்பிசைக் => பாப்பிசை
குழுவான => குழு
வீவா => வீவா
பொதுவாக => பொது
சாந்தகுமாரி => சாந்தகுமாரி
அசாமிய => அசாமி
தென்னிந்தியர்களிடையே => தென்னிந்தியர்களிடை
இசைக்குயில் => இசைக்குயில்
எனவும் => என
சின்னக்குயில் => சின்னக்குயில்
அழைக்கப்படுகிறார் => அழை
இல் => இ்
உயரிய => உயரி
வழங்கப்படுவதாக => வழம்
அறிவிக்கப்பட்டது => அறிவி
பணியாற்றியதற்காக => பணியாற்றியதல்
ஓடருத்தம்மாவ => ஓடருத்தம்
ஆளரியாம் => ஆளரியாம்
தொகுப்புகளையும் => தொகுப்பு
சேர்த்தலை => சேர்த்தல்
மாங்காடு => மாங்காடு
நடேசன் => நடேசன்
சசிகுமார் => சசிகு
பாலகுலங்கரா => பாலகுலங்கர்
அம்பிகாதேவி => பிகாதே
பெரும்பாவூர் => பெரும்பாவூர்
இரவீந்திரநாத் => இரவீந்திர
சுப்பிரமணியம் => சுப்பிரமணியம்
அடங்குவர் => அடம்
ராதாகிருஷ்ணன் => ராதாகிருஷ்ணன்
போன்றவர்கள் => போன்ற
வழிகாட்டிகளாகவும் => வழிகாட்டிகள்
ஆசிரியர்களாகவும் => ஆசிரியர்கள்
வடிவமைப்பதில் => வடிவமை
செல்வாக்கு => செல்
சுப்ரமணியபுரம் => சுப்ரமணியபுரம்
குலுங்க => குலும்
நாடோடிகள் => நாடோடி
ஆடுங்கடா => ஆ்
ஒத்த => ஒத்த
சொல்லால => சொல்லால
ஜேம்ஸ் => ஜேம்ஸ்
வசந்தனால் => வசந்தன்
அழைக்கப்பட்டது => அழை
திருப்புமுனை => திருப்புமு
கருதுகிறார் => கருது
நபரை => நபரை
பிரேம் => பிர்
அறியப்படுகிறார் => அறி
பிண்னணிப் => பிண்னணி
நகைச்சுவையாளர் => நகைச்சுவையாளர்
பாத்திரங்களில் => பாத்திரம்
நடித்துவருகிறார் => நடித்துவரு
மேடைப் => மேடை
உண்மையில் => உண்மை
எழுத்துப் => எழு
பிழையாகும் => பிழை
ஏனெனில் => ஏ
பிரேம் => பிர்
குறிக்கிறது => குறி
என்னா => என்
கொடும => கொடும
சார் => சார்
சொற்றொடர்களுக்காகவும் => சொற்றொடர்கள்
பிரபலமானவர் => பிரபலம்
எவ்வளவோ => வளவோ
பண்ணிட்டோம் => பண்ணிடு
இத => இத
பண்ணமாட்டோமா => பண்ணமாடு
வசனம் => வச
உரையாடல் => உரை
சந்திரமுகி => சந்திரமுகி
பிரபுவால் => பிரபு
பயன்படுத்தப்படும் => பயன்
வொய் => வொய்
திஸ் => திஸ்
கொலவெறி => கொலவெறி
பயணத்தின் => பயணம்
தொடக்கத்தில் => தொடக்கம்
அமைத்து => அமை
இசை => இசை
முரசு => முரசு
வெளிப்பட்டிணத்தில் => வெளிப்பட்டிணம்
ல் => ல்
முஹம்மது => முஹம்ம
இஸ்மாயில் => இஸ்
பீவி => பீவி
பிறந்தவராவார் => பிற
வெளிப்பட்டிணத்தைச் => வெளிப்பட்டிணம்
பாட்டனார் => பாட்ட
அம்மாவின் => மா
அப்பா => பா
ராவுத்தர் => ராவுத்தர்
அரண்மனையில் => அரண்ம
ஆயுதக் => ஆயுத
கிடங்கு => கிடம்
பாதுகாவலர் => பாதுகாவலர்
பராமரிப்பாளராகப் => பராமரிப்பாளர்
ஹனிபா => ஹனி
பூர்வீகம் => பூர்வீகம்
பெயரோடு => பெயர்
நாகூரும் => நாகூர்
விளங்கியவர் => விளங்கி
பங்களிப்பினைத் => பங்களி
தந்தவர் => த
இருநூறுக்கும் => இருநூ
வெளிவந்துள்ளன => வெளிவந்துள்ள
வானொலிகளில் => வானொலி
கள்களில்கச்சேரிகள் => கச்சேரி
ஒலிபரப்பப்பட்டுள்ளன => ஒலிபரப்பப்பட்டுள்ள
அசோக் => அசோ
நடத்தும் => நட
தேர்வானவர் => தேர்
அந்தப் => அந்த
பெற்றதன் => பெற்றதன்
பலனாக => பலனா
கோவா => கோவா
ஆண்ட்ரியா => ஆண்ட்ரி
ஜெரெமையாவுடன் => ஜெரெமை
தொழில்முனைவோர் => தொழில்முனைவோர்
திறனைக் => திற
நீடித்தது => நீடி
ஆயிரத்துக்கும் => ஆயிர
தனிப் => தனி
தொகுதிகளையும் => தொகுதி
பாடியுள்ளதோடு => பாடியுள்ள
பாடியதாகக் => பாடி
கின்னஸ் => கின்னஸ்
புத்தகத்தால் => புத்தகம்
அறிவிக்கப்பட்டார் => அறிவி
தாதாசாகேப் => தாதா
பாடகியான => பாடகி
மங்கேஷ்கரின் => மங்கேஷ்கர்
தென்னிந்தியத் => தென்னிந்தி
ஒருமுறையும் => ஒருமுறை
முறையும் => முறை
நான்குமுறையும் => நான்குமுறை
எர்ணாகுளத்தின் => எர்ணாகுளம்
இரவிபுரம் => இரவிபுரம்
கொச்சி => கொச்சி
அரச => அரச
பரம்பரையைச் => பரம்பரை
சேர்ந்தவருமான => சேர்ந்தவரும்
ரவிவர்மா => ரவி
கொச்சனியன் => கொச்சனியன்
தம்புரானுக்கும் => தம்புர்
சுபத்திரா => சுபத்திர்
குஞ்சம்மாவிற்கும் => குஞ்சம்
அன்னையின் => அன்
தூண்டலால் => தூண்டல்
வாசிக்கப் => வாசி
கிறித்தவ => கிறி
தேவாலயங்களில் => தேவாலயம்
பக்திப் => பக்தி
இரிஞ்சாலகுடாவில் => இரிஞ்சாலகு
தேசியப் => தேசி
மெல்லிசையில் => மெல்லிசை
பள்ளிச்சிறுவர்களுக்கான => பள்ளிச்சிறுவர்கள்
ஆம் => ஆம்
மிருதங்கக் => மிருதம்
செவ்விசைப் => செவ்விசை
விலங்கியலில் => விலங்கியல்
முடித்துக் => முடி
இசைப்பாடகியும் => இசைப்பாடகி
வருகின்றார் => வரு
இவருக்கும் => இவர்
பிரகாசுக்கும் => பிரகா
மேலாகப் => மேலா
ஆந்திரத் => ஆந்திர
திரைப்படத்துறையிலும் => திரைப்படத்துறை
திரைப்படங்களுக்காகப் => திரைப்படங்கள்
கௌரி => கௌரி
கணேசா => கணே
தசாப்தங்களுக்கு => தசாப்தங்கள்
இசைத்தொகுப்புகள் => இசைத்தொகுப்பு
முதன்மையாகப் => முதன்மை
பாடிவரும் => பாடி
பின்னிணிப் => பின்னிணி
யுகேந்திரனின் => யுகேந்திரன்
பிறந்தவரும் => பிற
ஹாரிசு => ஹாரிசு
ஜெயராஜின் => ஜெயராஜ்
பி => பி
செந்தில்கேனசன் => செந்தில்கேனசன்
சந்திரன் => சந்திரன்
அஞ்சலை => சலை
புதுக்கோட்டை => புதுக்கோடு
கலபம் => கல
கிராமத்தைச் => கிராமம்
திருச்சிராப்பள்ளி => திருச்சிராப்பள்ளி
மாணவராக => மாண
தஞ்சாவூர் => தஞ்சாவூர்
தங்கையா => தங்
திருடு => திருடு
போகாத => போகா
இராசலெட்சுமியுடன் => இராசலெட்சுமி
இயக்கும் => இய
கரிமுகன் => கரிமுகன்
நடித்துக் => நடி
கொண்டிருக்கிறார்படிப்புகளின் => படிப்பு
மண்ணுக்கேத்த => மண்ணுக்கே
ராகம் => ராகம்
தமிழ்நாட்டிலும் => தமிழ்நாடு
இடங்களிலும் => இடங்
ஆம் => ஆம்
மணிரத்னத்தின் => மணிர
திரைப்டத்திலிருந்து => திரைப்டத்தில்
ஃபிலிம்ஃபேர் => ஃபிலிம்ஃபேர்
சப்னா => சப்
அவஸ்தியுடன் => அவஸ்தி
மோஷன் => மோஷன்
காட்சி => காட்சி
ஊடகத்திற்கான => ஊடகத்தில்
வென்றது => வென்ற
ஹைடர் => ஹைடர்
பங்களிப்பு => பங்களிப்பு
என்றறியப்படும் => என்றறி
கலக்கப்போவது => கலக்கப்போ
யாரு => யாரு
அறிந்தும் => அறி
அறியாமலும் => அறி
சில் => சில்
தமிழ்நாட்டைச் => தமிழ்நாடு
சூசையப்பர் => சூசை
கல்லூரியின் => கல்லூரி
பேராசிரியராக => பேராசிரியர்
கலியபெருமாள் => கலியபெரும்
வளர்க்கப்பட்ட => வளர்
ரியாலிட்டி => ரியாலிட்டி
காட்சிகளிலும் => காட்சி
சிங்கரின் => சிங்கர்
பதிப்பிலும் => பதி
போட்டியிட்டார் => போட்டியிடு
தமிழ்நாட்டு => தமிழ்நாட்டு
சொல்லிசை => சொல்லிசை
கலைஞர்கள் => கலைஞர்
ஆவார்கள் => ஆவ்
இல் => இ்
ஆம்பள => ஆம்பள
சொல்லிசையின் => சொல்லிசை
இசைக்குழுக்களில் => இசைக்குழ்
கருதப்படுகிறார்கள் => கருத
இசையமைப்பாளர்களுள் => இசையமைப்பாளர்
திரைப்படத்துக்கு => திரைப்பட
அமைத்ததன் => அமைத்ததன்
திரையுலகிற்கு => திரையுல
இதுவரை => இது
படத்துறை => படத்துறை
சாரா => சாரா
இளையராஜாவுக்கு => இளையராஜ்
நாட்டின் => நாடு
புலமையும் => புலம்
பயிற்சியும் => பயிற்சி
திரைப்படங்களுக்கான => திரைப்படங்கள்
இசையமைப்புக்கும் => இசையமை
கையாளும் => கை
திறன்படைத்த => திறன்படை
தன்ராஜிடம் => தன்ராஜ்
பயின்றவர் => பயின்ற
போன்றவர்களிடம் => போன்ற
நினைவுகள் => நினைவு
பயணம் => பயணம்
நம்பிக்கை => நம்
மெட்டி => மெட்டி
‌திரைபடத்தில் => திரைபடம்
நிலா => நிலா
காய்கிறது => காய்
சௌராட்டிர => சௌராட்டிர
சமூகத்தைச் => சமூகம்
தென்னிந்தியாவின் => தென்னிந்தி
பழம்பெரும் => பழம்பெர்
களில்தமிழ்திரைப்படங்களில் => தமிழ்திரைப்படம்
உள்ளத்தில் => உள்ளம்
நீங்கா => நீம்
அத்தானும் => தான்
தானே => தானே
சித்தாடை => சித்தாடை
கட்டிக்கிட்டு => கட்டிக்கிட்டு
மண்ணை => மண்
நம்பி => நம்
மரமிருக்கு => மரமிர்
௭ன் => ௭ன்
மொழிகளுக்கு => மொழிகள்
இயக்குநர்களின் => இயக்குநர்
பின்னணிக்குரல் => பின்னணிக்குர்
மோகனுக்கானவை => மோகன்
யாகசாலை => யாகசால்
கும்கி => கும்கி
கையளவு => கையளவு
நெஞ்சத்திலே => நெஞ்சம்
வேடந்தாங்கலுக்கு => வேடந்தாங்கல்
மாலைப்புரம் => மாலைப்புரம்
மணிமாறனின் => மணிமாறன்
புத்தர் => புத்தர்
கலைக்குழுவில் => கலைக்குழு
அவரையே => அவரை
புரிந்துள்ளார் => புரிந்துள்
மணிமாறனே => மணிமாறன்
ஊக்கத்துக்கு => ஊக்க
காரணமானவர் => காரணம்
கூறியுள்ளார் => கூறியுள்
இசைக்கலை => இசைக்கல்
அரசி => அரசி
இளையராசாவின் => இளையர்
உடன்பிறப்புகளான => உடன்பிறப்புகள்
கார்த்திக்கு => கார்த்தி
இராசா => இரா
அமையும் => அமை
மயில் => மய்
போலப் => போல
ஒன்னு => ஒன்
இவருக்குச் => இவர்
திரையுலகிலும் => திரையுல
பணிக்காக => பணி
இயக்குனருக்கான => இய
பொண்ணுக்குத் => பொண்
தஞ்சாவூரு => தஞ்சாவூரு
சீமையிலே => சீமை
கண்ணு => கண்ணு
தாவி => தாவி
வந்தேன் => வ
பொன்னியம்மா => பொன்னியம்மா
பாடலே => பா
சசிரேகாவின் => சசிரே
முதற்பாட்டு => முதற்பாட்டு
அழைக்கப்பட்ட => அழை
செங்கோட்டை => செங்கோடு
கங்காதரன் => கங்காதரன்
காலத்துக்கு => கால
முன்பே => முன்
களில்பிரபலமாயிருந்த => பிரபலமாயிரு
செவ்வியல் => செவ்
பாடகியுமான => பாடகியும்
சுந்தராம்பாளின் => சுந்தர்
செங்கோட்டையில் => செங்கோட்டை
இராமகிருஷ்ணன் => இராமகிருஷ்ணன்
அப்பொழுது => பொழுது
திருவிதாங்கூர் => திருவிதாங்கூர்
சமஸ்தானத்தின் => சமஸ்
கங்காதர => கங்காதர
அய்யர் => யர்
பிறந்தோர் => பிறந்தோர்
சுப்புலட்சுமி => சுப்புலட்சுமி
சிவகாமி => சிவகாமி
அப்பாத்துரை => பாத்துர்
சுப்பையா => சு
செல்லப்பா => செல்ல
சங்கரன் => சங்கரன்
காசி => காசி
பிச்சம்மாள் => பிச்சம்
வீட்டிலுள்ளோர் => வீட்டிலுள்ளோர்
செல்லமாக => செல்லம்
அழைத்த => அழை
கிட்டன் => கிட்டன்
அதுவே => அது
பெயராக => பெயர்
நிலைத்து => நிலை
விட்டது => விட்ட
வறுமையினால் => வறுமை
கிடைக்கவில்லை => கிடை
சங்கரதாஸ் => சங்கரதாஸ்
சுவாமிகள் => சுவாமி
ஆதரவால் => ஆதர
இசையிலும் => இசை
நாடகக்கலையிலும் => நாடகக்கலை
பெறமுடிந்தது => பெறமுடி
எடுத்தார் => எடு
முதன்முதல் => முதன்மு
மேடையேறினார் => மேடையேறி
சிலோனில் => சிலோன்
அங்கிருந்த => கிரு
கலைத்திறமையைப் => கலைத்திறமை
பாராட்டித் => பாராட்டி
பதக்கமும் => பதக்கம்
சான்றிதழும் => சான்றிதழ்
வழங்கிப் => வழங்கி
பெருமைப் => பெரும்
படுத்தியது => படுத்தி
கொண்டிருந்த => கொண்டிரு
சுந்தராம்பாளுக்கும் => சுந்தர்
ல் => ்
திருமணமாகும் => திருமணம்
திருமணத்துக்குப் => திருமண
அமோகவெற்றி => அமோகவெற்றி
ஓயாத => ஓயாத
உழைப்பே => உழை
நலத்துக்குக் => நல
கேடாக => கேடா
திருவாரூரில் => திருவாரூர்
கொண்டிருக்கும்போது => கொண்டிருக்கும்போ
மேடையிலேயே => மேடையிலேய்
மயங்கி => மயங்கி
விழுந்து => விழு
ல் => ்
இறந்தபோது => இறந்தபோ
தான்தரண்குமார் => தரண்
பாரிஜாதம் => பாரிஜாதம்
பாகியராஜை => பாகியராஜ்
குருவாகப் => குரு
பாராட்டுகிறார் => பாராட்டு
வேட்டையாடு => வேட்டையாடு
விளையாடு => விளையாடு
மஞ்சள் => மஞ்சள்
வெய்யில் => வெய்
வெற்றியைத் => வெற்றி
தந்துள்ளன => தந்துள்ள
ஒளிபரப்பப்பட்ட => ஒளிபர
நிலைநிகழ்ச்சியான => நிலைநிகழ்ச்சி
ஜூனியரின் => ஜூனியர்
வென்றதில் => வென்ற
ஜெய்சி => ஜெய்சி
அறக்கட்டளையின் => அறக்கட்டளை
வல்லவர் => வல்ல
கிறித்தவக் => கிறி
இதழியல் => இதழி
செய்தித் => செய்தி
தொடர்பியல் => தொடர்
படித்துவந்த => படி
எஸ் => எஸ்
தயாளின் => தய்
பல்லே => பல்
லக்கா => ல
டாக்சி => டாக்சி
மணப் => மண
பெண்ணே => பெண்
நடனம் => நட
ஆடுவதிலும் => ஆடு
விருப்பமும் => விரு
ஆற்றலும் => ஆ
ஒலிப்பதிவாளர் => ஒலிப்பதிவாளர்
நேரலை => நேரல்
நிகழ்த்துநர் => நிகழ்த்துநர்
மொழிப்பாடல்கள் => மொழிப்பாடல்
மட்டுமின்றி => மட்
குஜராத்தி => குஜராத்தி
துளுவம் => துளுவம்
தொகுதிகளில் => தொகுதி
சம்பளம் => சம்பளம்
ஒருவராகத் => ஒரு
திகழ்கிறார் => திகழ்
ஹரியானாவில் => ஹரி
பரீதாபாதுவில் => பரீதாபாது
அகம் => அகம்
சோபா => சோபா
கயஸ்தா => கயஸ்
வகுப்பைச் => வகு
தீஷா => தீஷா
நிகமும் => நிகம்
தொழில்முறைப் => தொழில்முறை
இசைத்துறையில் => இசைத்துறை
பக்திப்பாடல்களிலும் => பக்திப்பாடல்
புகழ்பெற்று => புகழ்பெற்று
விளங்கிய => விளங்கி
இரட்டையருக்கு => இரட்டையர்
ரஞ்சனி => ரஞ்சனி
காயத்ரி => காயத்ரி
பிரியா => பிரி
விளங்கினர் => விளங்கி
சிவகங்கை => சிவகம்
திருப்புவனம் => திருப்பு
வட்டம் => வட்டம்
ஊராட்சி => ஊராட்சி
ஒன்றியத்தில் => ஒன்றியம்
சேர்நத => சேர்ந
சிறுவயது => சிறு
கோயில் => கோய்
திருவிழாக்கள் => திருவிழா
சடங்குகள் => சடம்
வீடுகளில் => வீடு
பாடுபவர் => பாடு
செல்வராஜ் => செல்வராஜ்
ல் => ்
திரையரங்குகளில் => திரையரம்
வெளியாக => வெளி
கர்ணன் => கர்ணன்
கண்டா => கண்
வரச்சொல்லுங்க => வரச்சொல்லும்
நாட்டுப்புறப் => நாட்டுப்புற
உலகின் => உல
செய்தவர் => செய்
இயற்பெயரைக் => இயற்பெயர்
சித்தார்த்தி => சித்தார்த்தி
தைப்பூச => தைப்பூச
திருநாளில் => திரு
கோவையில் => கோவை
சுந்தரம் => சுந்தரம்
அலமேலு => அலமேலு
அரியூர் => அரியூர்
உஞ்சவிருத்தி => சவிருத்தி
ருக்மணியம்மாள் => ருக்மணியம்
முருகதாசுக்கு => முரு
செல்லம்மாள் => செல்லம்
கோபாலகிருஷ்ணன் => கோபாலகிருஷ்ணன்
திருவண்ணாமலையில் => திருவண்ணாமலை
இரமண => இரமண
மகரிஷியை => மகரிஷி
சந்தித்த => சந்தி
வழிக்கு => வழி
வந்ததாக => வ
பேட்டி => பேட்டி
கூறியிருந்தார் => கூறியிரு
சுந்தரம்பிள்ளை => சுந்தரம்பிள்
க்கும்க்கும்இடைப்பட்ட => இடை
இடம்பெற்றன => இடம்பெற்ற
நகரமான => நகரம்
சிதம்பரத்தில் => சிதம்பரம்
வாய்ப்பாட்டுக் => வாய்ப்பாடு
மு => மு
தலைவரும் => தலை
முன்னாள் => முன்
முதலமைச்சருமான => முதலமைச்சரும்
கருணாநிதியின் => கருணாநிதி
பத்மாவதியின் => பத்மாவதி
அண்ணனும் => அண்ணன்
முத்துவின் => மு
தாய்மாமனும் => தாய்மாமன்
கருணாநிதி => கருணாநிதி
எழுத்தாளராக => எழுத்தாளர்
அறிமுகமாவதற்குக் => அறிமுகம்
தை => தை
துருவன் => துரு
தங்காள் => தங்
லீலாவதி => லீலாவதி
சுலோச்சனா => சுலோச்சன்
பூம்பாவை => பூம்
தமிழ்நாட்டுத் => தமிழ்நாட்டு
சுள்ளான் => சுள்
புதுப்பேட்டை => புதுப்பேடு
பொல்லாதவன் => பொல்
வேலையில்லா => வேலை
பட்டதாரி => பட்டதாரி
அசுரன் => அசுரன்
ராஞ்சனா => ராஞ்சன்
நடித்ததன் => நடித்ததன்
திரையுலகின் => திரையுல
நடிகர்களில் => நடிகர்
ஒருவராவார் => ஒரு
மேலான => மேலா
சர்வதேசத் => சர்வதேச
பிரபலங்களின் => பிரபலம்
வருவாயை => வரு
ஃபோர்ப்ஸ் => ஃபோர்ப்ஸ்
சேர்க்கப்பட்டுள்ளார் => சேர்க்கப்பட்டுள்
வுண்டர்பார் => வுண்டர்
பிலிம்ஸ் => பிலிம்ஸ்
தயாரிக்கிறார் => தயாரி
விசாரனை => விசார
பிண்ணணி => பிண்ணணி
வைஷ்ணவா => வைஷ்ண
நிர்வாகத்தை => நிர்வாகம்
பிரபலமானவை => பிரபலம்
தமிழச்சி => தமிழச்சி
கட்டிகிட => கட்டிகிட
காக்கி => காக்கி
சட்டை => சடு
ரோபோ => ரோபோ
ரோமியோ => ரோமி
தமிழுக்கு => தமிழ்
எண் => எண்
ஒன்றை => ஒல்
அழுத்தவும் => அழு
ஆட்டக்கார => ஆட்டக்கார
மாமன் => மாமன்
இசைஞானி => இசைஞானி
ஆவது => ஆ
கிருஷ்ணசந்தரன் => கிருஷ்ணசந்தரன்
பின்னணிக் => பின்னணி
இன்றளவும் => இன்றள
துணைக்கண்டத்திலும் => துணைக்கண்டம்
இந்தியர்கள் => தியர்
வாழும் => வாழ்
கென்யா => கென்
நாடுகளிலும் => நாடு
புகழ்பெற்றவர் => புகழ்பெற்ற
மொழிப்பாடகராக => மொழிப்பாடகர்
போச்புரி => போச்புரி
சிந்தி => சிந்தி
மாகாகி => மா
பார்சி => பார்சி
அரபி => அரபி
டச்சு => டச்சு
கிரியோல் => கிரியோ்
ஆகியவற்றிலும் => ஆகி
நடிகர்களின் => நடிகர்
பாடுவதாலும் => பாடு
உதட்டசைவை => உதட்டசை
ஒத்தபடி => ஒத்த
பாடுவதால் => பாடு
பத்மஶ்ரீ => பத்மஶ்ரி
பெற்றோருக்குப் => பெற்றோர்
தற்போதைய => தற்போதை
அம்ரிஸ்டர் => ரிஸ்டர்
நகருக்கு => நகர்
அருகேயுள்ள => அருகேய்
மஜிதா => மஜி
இடமாகும் => இடமா
தெருவில் => தெரு
பாடிச் => பாடி
பகீர்களைப் => பக்
போல => போல
திறமையுடையவர் => திறமையுடை
உஸ்தாத் => உஸ்
படே => படே
வஹீத் => வஹீ
ஜீவன்லால் => ஜீ
இசையினைக் => இசையி
உறவினராக => உறவி
மனைவியுடனான => மனைவியுடன்
சொந்தக் => சொ
நடைபெற்றது => நடைபெற்ற
பாகிஸ்தான் => பாகிஸ்
பிரிவினையின் => பிரிவி
ரபியின் => ரபி
பஸிரா => பஸிர்
கொல்லப்பட்டதால் => கொல்லப்பட்ட
வசிக்க => வசி
விரும்பாமல் => விரும்
லாகூர் => லாகூர்
இடம்பெயர்ந்தால் => இடம்பெயர்
பில்குஸ் => பில்குஸ்
இறகுப்பந்தாட்டம் => இறகுப்பந்தாட்டம்
கேரம் => கேரம்
பறக்கவிடுதல் => பறக்கவிடு
பொழுதுபோக்கு => பொழுதுபோ
ஏமல => ஏமல
சுருக்கமாக => சுருக்கம்
பாடகர்களுள் => பாடகர்
கள்இசையமைத்தும் => இசையம்
பிரபலப் => பிரபல
ஜிக்கி => ஜிக்கி
பெரும்பான்மையாக => பெரும்பான்மை
படங்களிள் => படங்களிள்
இசையமைப்பாளராகக் => இசையமைப்பாளர்
கருதப்படும் => கருத
பயன்படுத்தியதற்காக => பயன்படுத்தியதல்
அறியப்படுபவர் => அறி
அறிமுகப்படுத்தியவர் => அறிமுகப்படுத்தி
நாட்டில் => நாடு
ரீமிக்ஸ் => ரீமிக்ஸ்
கலாச்சாரத்தை => கலாச்சாரம்
அதனை => அதனை
பிரபலபடுத்தியவர் => பிரபலபடுத்தி
ராம் => ராம்
சைப்ரஸ் => சைப்ரஸ்
படைப்புகள் => படைப்பு
விசுவாசமான => விசுவாசம்
ரசிகர் => ரசிகர்
பட்டாளம் => பட்டாளம்
யூத் => யூ
ஐகான் => ஐகான்
புனைப்பெயரைப் => புனைப்பெயர்
பெற்றுத்தந்தது => பெற்று
வருட => வருட
காலத்திற்குள் => காலத்தில்
துள்ளுவாதோ => துள்ளு
சினிமாவின் => சினிம்
இசையமைப்பாளர்களில் => இசையமைப்பாளர்
உருவெடுத்தார் => உருவெடு
லேபிளான => லேபிள்
ரெக்கார்ட்ஸை => ரெக்கார்ட்ஸ்
ஒய் => ஒய்
விருதுகளுக்காக => விருதுகள்
பரிந்துரைகளையும் => பரிந்துரை
தந்தையான => தந்தை
சந்திரசேகர் => சந்திரசேகர்
ஏறத்தாழ => ஏறத்தாழ
படங்களுக்குப் => படங்கள்
இடத்தைத் => இடம்
தக்கவைத்துக் => தக்க
நடிகர்களுள் => நடிகர்
ஒருவராகக் => ஒரு
காணப்படுகிறார் => காண
இளையதளபதி => இளையதளபதி
அழைக்கிறார்கள் => அழை
புலம்பெயர்ந்த => புலம்பெயர்
சப்பான் => ச
நாடுகளில் => நாடு
நேயர்கள் => நேயர்
கண்டங்கள் => கண்டம்
எண்பது => எண்ப
வெளியாகி => வெளி
எங்கள்நீதி => நீதி
நடிகராகத் => நடிகர்
ம் => ம்
நாளைய => நாளை
தீர்ப்பு => தீர்ப்பு
விக்ரமன் => விக்ரமன்
திருப்புமுனையாக => திருப்புமு
இன்று => இன்று
காஸ்மோபாலிடன் => காஸ்மோபாலிடன்
சிமா => சிமா
ஐக்கியப் => ஐக்கி
பேரரரசின் => பேரரர
நாட்டு => நாட்டு
விருதுகளுக்குப் => விருதுகள்
பரிந்துரைக்கப்பட்டுள்ளார் => பரிந்துரைக்கப்பட்டுள்
பாப்பா => பா
ஆடல் => ஆடல்
சீனாவின் => சீனா
ஷாங்காய் => ஷாம்
பன்னாட்டுத் => பன்னாட்டு
ஆஸ்திரேலியாவின் => ஆஸ்திரேலி
மெல்போர்ன் => மெல்போர்
தென்கொரியாவின் => தென்கொரி
புச்சியான் => புச்சி
திரையிடப்பட்டுள்ளன => திரையிடப்பட்டுள்ள
இசைக்குப் => இசை
கொடுத்திருக்கிறார் => கொடுத்திர்
படுகா => பட்
ஏழாயிரத்திற்கும் => ஏழாயிரம்
ஸ்வரங்களின் => ஸ்வரம்
அரசி => அரசி
இந்தியாவின் => இந்தி
குயின் => குயின்
கருத்தம்மா => கருத்தம்
போறாளே => போ
பொன்னுத்தாயி => பொன்னுத்தாயி
நடிகருமாவார் => நடிகரும்
தைக்குடம் => தைக்குடம்
கப்பா => க
தொலைக்கட்சியில் => தொலைக்கட்சி
மோஜோ => மோஜோ
நிகழ்ச்சிக்காக => நிகழ்ச்சி
தசரதம் => தசரதம்
மந்தராச்செபுண்டோ => மந்தராச்செபுண்டோ
பிடித்தது => பிடி
குடியேறிய => குடியேறி
சத்யநாதன் => சத்யநாதன்
பரியதாத் => பரி
ஷீலா => ஷீலா
விமான => விமா
ஊழியராவார் => ஊழியர்
திருச்சூரின் => திருச்சூர்
இரிஞ்ஞாலகுடா => இரிஞ்ஞாலகு
பகுதியைச் => பகுதி
வருமான => வரும்
வரித்துறையில் => வரித்துறை
பணிபுரிகிறார் => பணிபுரி
கோட்டயம் => கோட்டயம்
நகரைச் => நகரை
ஷரத் => ஷர
இங்கிலாந்தில் => கிலா
விஞ்ஞானியாக => விஞ்ஞானி
மகாராட்டிராவின் => மகாராட்டிர்
கோரேகாவ் => கோரே
பகுதியிலுள்ள => பகுதி
வித்யாலயா => வித்யாலய்
வணிகக் => வணிக
பயின்று => பய்
கல்லூரியான => கல்லூரி
கன்சர்வேட்டரியில் => கன்சர்வேட்டரி
கொச்சியில் => கொச்சி
பலா => பலா
சீனிவாசின் => சீனி
பயன்பாட்டின்போது => பயன்பாட்டின்போ
வங்காளத் => வங்காள
திரையுலகம் => திரையுலகம்
ரவீந்திர => ரவீந்திர
சங்கீதத்தின் => சங்கீதம்
நிபுணராகவும் => நிபுணர்
பங்களிப்புக்காக => பங்களி
வழங்கப்படுவது => வழம்
கொல்கத்தாவில் => கொல்கம்
மோனிமோகன் => மோனிமோகன்
மோனோமோகினி => மோனோமோகினி
தந்தைக்குப் => தந்தை
ஆழ்ந்த => ஆழ்
துர்காதாஸ் => துர்காதாஸ்
பாண்டியோபாத்யாயா => பாண்டியோ
ஆரம்பப் => ஆரம்
கொல்கத்தா => கொல்
முடித்ததும் => முடி
தாகூரின் => தாகூர்
தினேந்திரநாத் => தினேந்திர
தாகூருடன் => தாகூர்
கொண்டபோது => கொண்டபோ
முல்லிக்கின் => முல்லி
நீடித்த => நீடி
ஆர்வத்திற்கு => ஆர்வத்தி
வழிவகுத்தது => வழிவகு
தாகூர் => தாகூர்
விரும்பினார் => விரும்பி
கலைஞர்களில் => கலைஞர்
அறியப்பட்டார் => அறி
கட்டசேரி => கட்டசேரி
யோசஃப் => யோசஃ
புகழ்பெற்றத் => புகழ்பெற்ற
திரைவாழ்வில் => திரைவாழ்
உருசிய => உருசி
அராபிய => அரா
இலத்தீன் => இலத்தீன்
கூடுதலான => கூடுதல்
திரைப்பாடல்களைப் => திரைப்பாடல்
திரைப் => திரை
எந்தப் => எந்த
சாதிக்காத => சாதி
கேரளம் => கேரளம்
கர்நாடகம் => கர்நாடகம்
ஆந்திரப்பிரதேசம் => ஆந்திரப்பிரதேசம்
அரசுகளிடம் => அரசு
மொத்தம் => மொத்தம்
திரைப்பாடகராக => திரைப்பாடகர்
திரையிசைத் => திரையிசை
சமயப் => சமய
மெல்லிசைப்பாடல்கள் => மெல்லிசைப்பாடல்
இசைத்தொகுப்புகளையும் => இசைத்தொகுப்பு
இயக்குனராகவும் => இய
கந்தர்வன் => கந்தர்
அழைக்கின்றனர் => அழை
நாற்பத்து => நா
அரசுகள் => அரசு
கொடுத்த => கொடு
வங்கம் => வங்கம்
சிவில் => சி
கலைகளுக்கு => கலைகள்
சிஎன்என் => சிஎன்என்
ஐபிஎன் => ஐபிஎன்
யேசுதாசுக்கு => யேசு
அங்கீகாரங்களின் => கீகாரம்
பரவலாகக் => பரவல்
வேங்கடேஸ்வர => வேங்கடேஸ்வர
குடிவாடா => குடி
தாலூக்காவிலுள்ள => தாலூ
சௌதப்பள்ளி => சௌதப்பள்ளி
சூரய்யா => சூரய்
ரத்தம்மா => ரத்தம்
தீர்த்தரின் => தீர்த்தர்
தரங்கிணிகளைப் => தரங்கிணி
பையனாக => பையன்
வாசிக்க => வாசி
அந்தத் => அந்த
தாளத்திற்கேற்ப => தாளத்திற்கே
நடனமாடுவார் => நடனமாடு
தொண்டி => தொண்டி
சாலையில் => சாலை
முன்னோடிகளில் => முன்னோடி
உதாரணமாகத் => உதாரணம்
திகழ்ந்தார் => திகழ்
நிகழ்த்துனராகத் => நிகழ்
பணியைத் => பணி
நடிக்கத் => நடி
இல் => இ்
விக்கிப்பீடியா => விக்கிப்பீடி
இலஞ்சம் => இலஞ்சம்
மக்கள்தொகைப் => மக்கள்தொகை
பெருக்கம் => பெருக்கம்
ஊழல்கள் => ஊழல்
மூட => மூட
நம்பிக்கைப் => நம்
போன்றவற்றை => போன்ற
இடித்துரைப்பதால் => இடித்துரை
சிலர் => சிலர்
சின்னக் => சின்
சனங்களின் => சனங்
கலைஞன் => கலைஞன்
அடைமொழியிட்டு => அடைமொழியிட்டு
உருவாக்குநர் => உருவாக்குநர்
எழுதுபவரும் => எழுது
பாடகராகப் => பாடகர்
உட்படப் => உட்பட
பிரதேசத்தில் => பிரதேசம்
காக்கிநாடா => காக்கி
தயாரித்து => தயாரி
சம்பத் => சம்ப
கனஹிபரது => கனஹிபர
சிந்தனை => சி
செல்வமே => செல்வமே
ஜாதகம் => ஜாதகம்
புலமை => புலம்
மதுவண்டு => மதுவண்டு
புனைப்பெயரில் => புனைப்பெயர்
கவிதைகளை => கவிதை
வறுமையின் => வறுமை
நிறம் => நிறம்
சிவப்பு => சிவப்பு
நண்டு => நண்டு
இந்திப்பாடல்களை => திப்பாடல்
இவரே => இவரே
இயற்றினார் => இயற்றி
புகழுச்சியில் => புகழுச்சி
உச்சஸ்தாயியில் => சஸ்தாயி
பாடிவந்தோர் => பாடிவந்தோர்
மென்மையான => மென்மை
இனிமையைக் => இனிமை
கூட்டி => கூட்டி
பாணியை => பாணி
கொண்டுவந்தவர் => கொண்டு
அவள் => அவள்
பெரும்புகழை => பெரும்புகழ்
ஈட்டினார் => ஈட்டி
கணேசனுக்கும் => கணேசன்
ராஜ்குமாருக்கும் => ராஜ்
அநேகமாக => அநேகம்
அனைத்துப் => அனை
விருதுபெற்ற => விருதுபெற்ற
அழைத்து => அழை
மாநிலம் => மாநிலம்
மலையாளத்தைத் => மலையாளம்
ராமகிருஷ்ணா => ராமகிருஷ்
மிஷன் => மிஷன்
விவேகானந்தா => விவே
பாரிஸ் => பாரிஸ்
மிட்டாய் => மிடு
கம்பெனியில் => கம்பெனி
நிர்வாகியாக => நிர்வாகி
என்பதற்காக => என்பதல்
வேலையைத் => வேலை
துறந்து => துற
இசைத்துறைக்கு => இசைத்துறை
வகையிலான => வகையில்
இன்ஸ்ட்டாகிராம் => இன்ஸ்ட்டாகிர்
ஊடாகப் => ஊடாக
தென்னிந்தியாவைச் => தென்னிந்தி
இற்கும் => இ்
நாற்பதாயிரத்திற்கும் => நாற்பதாயிரம்
பாடல்களைத் => பாடல்
சிஷ்ட்லா => சிஷ்
ஶ்ரீராமூரிதி => ஶ்ரீராமூரிதி
பாடகரை => பாடகர்
ஜானகியம்மா => ஜானகியம்மா
குறிப்பிடப்படுகிறார் => குறிப்பிட
கோரஸ் => கோரஸ்
ஆல்பங்கள் => ஆல்பம்
அசாமி => அசாமி
விலையாட்டு => விலையாட்டு
திரைப்படத்துடன் => திரைப்பட
பரவியுள்ளது => பரவியுள்ள
நைட்டிங்கேல் => நைட்டிங்கேல்
விருதினையும் => விருதி
கெளரவ => கெளர
அறிவித்த => அறிவி
பூஷன் => பூஷன்
மறுத்துவிட்டார் => மறுத்துவிடு
மிகவும் => மிக
தாமதமாக => தாமதமாக
வந்துவிட்டது => வந்துவிட்ட
வழங்கப்படவில்லை => வழங்கப்பட
சுட்டிக்காட்டினார் => சுட்டிக்காட்டி
ஆகியோருடனான => ஆகியோருடன்
பேசப்படுகிறது => பேச
முதலிடத்தில் => முதலிடம்
வகை => வகை
தோற்றங்களுக்காக => தோற்றங்கள்
பாடுவதிலிருந்து => பாடுவதில்
பெறுவதாக => பெறு
அறிவித்தார் => அறிவி
சகோதரத்துவத்தின் => சகோதரத்துவம்
அழுத்தத்தின் => அழுத்தம்
பண்ணாடி => பண்ணாடி
ராதிகா => ராதி
சரத்குமார் => சர
தினாவுக்கு => தினா
மிடில் => மி
கிளாஸ் => கிளாஸ்
மாதவன் => மாத
சேது => சேது
விண்ணுக்கும் => விண்
மண்ணுக்கும் => மண்
பிதாமகன் => பிதாமகன்
புரிந்த => புரி
வரையில் => வரை
மிலான் => மில்
நடிப்பாற்றல் => நடி
மூலமாகத் => மூலம்
வகிக்கும் => வகி
நடிகருள் => நடிகர்
நின்று => ந்
நடத்தியுள்ளார் => நடத்தியுள்
குடிசார் => குடி
அமைப்பின் => அமை
தூதர் => தூதர்
சஞ்சீவனி => சஞ்சீவனி
தூதுவராகவும் => தூது
மாற்றுத் => மாற்று
திறன் => திறன்
பள்ளியின் => பள்ளி
நலப்பணியின் => நலப்பணி
வேளையிலும் => வேளை
ஆட்படுத்திக் => ஆட்படுத்தி
நலத் => நல
செயல்படுத்தி => செயல்படுத்தி
காசுமீரி => காசுமீரி
உத்தரபிரதேச => தரபிரதேச
மாநிலத்தைச் => மாநிலம்
மீரட்டில் => மீரடு
சுஃபி => சுஃ
உள்ளவர் => உள்ள
விளங்குபவர் => விளம்
ஆம் => ஆம்
தோல்விப்படமான => தோல்விப்படம்
வைசா => வைசா
ஹோதா => ஹோதா
பார்ட் => பார்
அல்லாஹ் => அல்லாஹ்
பந்தே => ப
அறியப்படலானார் => அறியப்படல்
முற்போக்கு => முற்போ
மாவட்டச் => மாவட்ட
செயலராகவும் => செயலர்
பொதுவுடமைக் => பொதுவுடம்
கொள்கை => கொள்
விளக்கப் => விள
ஒளிபரப்பான => ஒளிபர
பங்குபெற்று => பங்குபெற்று
முதற்பரிசினைப் => முதற்பரிசி
பர்மனின் => பர்மன்
வாத்திய => வாத்தி
இயங்குகிறார் => இயம்
அரசாங்கத்தால் => அரசாங்கம்
விதிவிலக்கான => விதிவில
சாதனைக்கான => சாத
ஆம் => ஆம்
இளமணி => இளமணி
ஜனனிக்கு => ஜனனி
மேல்நாட்டுச் => மேல்நாட்டு
செந்நெறி => செந்நெறி
பெற்றவராவார் => பெற்ற
அரங்கப் => அரம்
பதிவுக்காக => பதி
ஆகியவற்றையும் => ஆகி
வானொலியின் => வானொலி
தர => தர
திரைப்படப்பாடகர் => திரைப்படப்பாடகர்
ஏகாம்பரேஷ் => ஏகாம்பரேஷ்
காபி => காபி
வித் => வி
அனு => அனு
ஹரிணியை => ஹரிணி
ஸ்மிரிதி => ஸ்மிரிதி
பிரத்யங்கர் => பிரத்யங்கர்
தெய்வீக => தெய்வீ
மகாநதி => மகாநதி
நடித்ததால் => நடி
அறிப்படுகிறார் => அறி
குசராத்தி => குசராத்தி
இந்தியாவைச் => தியா
ஜக்ஜித் => ஜக்ஜி
தலத் => தல
அஜிஸ் => அஜிஸ்
கஜல் => கஜல்
பாடகர்களைப் => பாடகர்
இசையுலகில் => இசையுல
பிரதானப்படுத்தி => பிரதானப்படுத்தி
பிரபலமடைந்தவர் => பிரபலமடை
நாம் => நாம்
சிட்டி => சிட்டி
ஆயி => ஆயி
ஹை => ஹை
மிகப்பிரபலமடைந்து => மிகப்பிரபலமடை
அதைத்தொடர்ந்து => அதைத்தொடர்
இசைத்தொகுதிகளை => இசைத்தொகுதி
வெளியிட்டுள்ள => வெளியிடு
உலகளவில் => உலகள
அறியப்பட்டுள்ளார் => அறியப்பட்டுள்
குஜராத் => குஜர்
ராஜ்கோட் => ராஜ்
ஜேட்பூர் => ஜேட்பூர்
குஜராத்திக் => குஜராத்தி
கேஷுபாய் => கேஷு
ஜித்துபென் => ஜித்துபென்
உதாஸின் => உதாஸ்
மன்ஹர் => மன்ஹர்
உதாஸ் => உதாஸ்
நிர்மல் => நிர்
நன்கறியப்பட்ட => நன்கறி
அறிமுகமானவரும் => அறிமுகம்
பால => பால
அட்டகத்தியில் => அட்டகத்தி
ஆடி => ஆடி
போனா => போனா
ஆவணி => ஆவணி
நடுக்கடலுல => நடுக்கடலுல
கப்பல => கப்பல
தேவாவிற்குப் => தேவாவி
பின்னதாக => பின்
மீள்வரவு => மீள்வரவு
செய்வதில் => செய்
வரிகளையும் => வரி
இயற்றி => இயற்றி
மாவட்டத்திலுள்ள => மாவட்டம்
ஊரைச் => ஊரை
பாடியுள்ள => பாடி
புகழ்பெற்றப் => புகழ்பெற்ற
பிரபாவிற்கு => பிரபாவி
நீண்டநாள் => நீண்ட
தர்சனாவை => தர்சன்
இருவருக்கும் => இரு
அம்மெயா => மெயா
அசோகமித்திரனின் => அசோகமித்திரன்
தண்ணீர் => தண்
நாவல் => நா
வசந்தசாய் => வச
திரைப்படமாக => திரைப்படம்
எடுக்கப்படவிருக்கிறது => எடுக்கப்படவிர்
அமைப்பதன் => அமைப்பதன்
அமைப்பாளராகவிருக்கிறார் => அமைப்பாளராகவிர்
சந்த் => ச
மத்தூர் => மத்தூர்
ரபீ => ரபீ
தேய் => தேய்
கள்செலுத்தினார் => செலுத்தி
டெல்லியில் => டெல்லி
ஜோராவார் => ஜோரா
முகேஷ் => முகேஷ்
குழந்தையாவார் => குழந்தை
முகேஷின் => முகேஷ்
பியாரிக்கு => பியாரி
சொல்லிக்கொடுக்க => சொல்லிக்கொ
பக்கத்து => பக்க
அறையில் => அறை
கேட்டுக்கொண்டிருக்கும் => கேடு
பரமேஷ்வரி => பரமேஷ்வரி
தாஸ் => தாஸ்
பணிகளின் => பணி
டெல்லித் => டெல்லி
செய்வதற்காக => செய்வதல்
வகுப்பிற்குப் => வகுப்பி
விடுத்தார் => விடு
பார்த்துக்கொண்டிருக்கும் => பார்
பதிவுகளை => பதிவு
பார்த்தார் => பார்
சிறிதாக => சிறி
வளர்த்துக்கொண்டார் => வளர்த்துக்கொண்
திருமணத்தில் => திருமணம்
குரலானது => குரல்
தூரத்து => தூர
மோதிலால் => மோதில்
கவனிக்கப்பட்டது => கவனி
பம்பாய்க்கு => பம்
ஜெகனாத் => ஜெகன்
முகேஷிற்கு => முகேஷி
வகுப்பிற்கு => வகுப்பி
நிர்தோஷ் => நிர்தோஷ்
இன்னொசென்ட் => இன்னொசென்
பாத்திரத்தை => பாத்திரம்
முயன்று => முயன்று
நிர்தோஷிற்காக => நிர்தோஷில்
ஹீ => ஹீ
புஜ்ஹா => புஜ்ஹ்
ஹுவா => ஹுவா
தூ => தூ
வாய்ப்பை => வாய்
அனில் => அன்
பிவாஸால் => பிவாஸ்
இசையமைக்கப்பட்டு => இசையமை
ஆஹ் => ஆஹ்
சிட்டாபூரி => சிட்டாபூரி
பர்ஸ்ட் => பர்ஸ்
லுக் => ல்
மோதிலாலுக்காகவே => மோதிலால்
பெஹ்லி => பெஹ்லி
நசர் => நசர்
மூலமாகப் => மூலம்
ஜல்டா => ஜல்
டூ => டூ
ஹல்னே => ஹல்
உங்களது => களது
நெஞ்சு => நெஞ்சு
எரிந்தால் => எரி
எரியட்டும் => எரியடு
விடுங்கள் => விடும்
தற்செயலாய் => தற்செயல்
இப்பாடல் => பா
படமாக்கப்பட்டது => படமா
களிலும்ஏனைய => ஏனை
மொழிப் => மொழி
சிலவற்றிலும் => சில
கொண்டவை => கொண்ட
காட்சிகளுக்குப் => காட்சிகள்
பயன்படுத்தப்பட்டன => பயன்படுத்தப்பட்ட
களில்களின்நாயுடு => நாயுடு
வெ => வெ
தங்கப்பதுமை => தங்க
தங்கமலை => தங்கமல்
ரகசியம் => ரகசியம்
மாமியார் => மாமி
மெச்சின => மெச்சி
மருமகள்‎ => மருமகள்‎
பொம்மை => பொம்
பெரிசு => பெரிசு
தாமரைக்குளம் => தாமரைக்குளம்
கிசோர் => கிசோர்
ஒக்டோபர் => ஒக்டோ
படைப்பாளி => படைப்பாளி
பன்முகம் => பன்முகம்
கொண்டவராக => கொண்ட
நெடும்பயணத்தில் => நெடும்பயணம்
அவதாரத்தில் => அவதாரம்
பவனிவந்த => பவனி
இசைத்துறையின் => இசைத்துறை
மூலம்தான் => மூலம்
நாடறிந்த => நாடறி
நட்சத்திரமாகப் => நட்சத்திரம்
முடிசூடா => முடிசூ
மன்னனாகத் => மன்
திகழ்ந்த => திகழ்
கிஷோர்தா => கிஷோர்தா
ரசிகர்களால் => ரசிகர்
அன்புடன் => அன்
குரலால் => குரல்
ரசிகர்களை => ரசிகர்
வசப்படுத்தி => வசப்படுத்தி
பல்லாயிரக்கணக்கானப் => பல்லாயிரக்கண
சரித்திரம் => சரித்திரம்
படைத்தார் => படை
உலகை => உலகை
வலம்வந்த => வலம்
மாபெரும் => மாபெர்
கலைஞனின் => கலைஞன்
சாதனைகளை => சாத
விரிவாகக் => விரி
காண்போம் => காண்
மார்ச்சு => மார்ச்சு
விருதுகளும் => விருது
உச்சத்தொனியில் => சத்தொனி
பக்திப்பாடல்கள் => பக்திப்பாடல்
தேவதையைக் => தேவதை
கண்டேன் => கண்டேன்
கொண்டேன் => கொண்
சக்கர => சக்கர
யூத் => யூ
மெல்லினமே => மெல்லி
மெல்லினமே => மெல்லினமே
ஷாஜஹான் => ஷாஜஹ்
பெற்றுள்ளன => பெற்றுள்ள
அருண்பாண்டியனுடன் => அருண்பாண்டியன்
நாயகன் => நாயகன்
அஜித்திற்கு => அஜித்தி
அண்ணன் => அண்ணன்
ஹரிசின் => ஹரி
ஸ்ரீனிவாசாகும் => ஸ்ரீனி
ஒளிப்படக் => ஒளிப்பட
ராகவேந்திரனின் => ராகவேந்திரன்
மகனாவார் => மகனா
கோயம்புத்தூர் => கோயம்புத்தூர்
படமொன்றிற்கு => படமொன்றி
முதலாண்டில் => முதலாண்
வா => வா
சகி => சகி
யடைந்தது => யடை
ஆயினும் => ஆய்
கல்லூரிப் => கல்லூரி
துறந்தார் => துற
வணிகவியல் => வணிக
பட்டமும் => பட்டம்
பொதுத் => பொது
தாளியலில் => தாளியல்
மேற்படிப்பும் => மே
பொறியியலிலும் => பொறியியல்
நிற்பதுவே => நி
நடப்பதுவே => நடப்பதுவே
பெருவெற்றி => பெருவெற்றி
யடைந்ததுடன் => யடை
இந்நேரத்தில் => நேரம்
மாற்றிக் => மாற்றி
ரீமிக்ஸ் => ரீமிக்ஸ்
இல் => இ்
மஸ்கட்டில் => மஸ்கடு
படங்களைத் => படங்
ஆல்பங்களிலும் => ஆல்பம்
கொல்கத்தாவைச் => கொல்கம்
ராக் => ரா
இசையமைத்துவருகிறார் => இசையமைத்துவரு
சுதாக்சனா => சுதாக்சன்
ரங்கசாய் => ரங்க
ஆகியோராவர் => ஆகியோர்
சாக்கோ => சா
ராண்டாமன் => ராண்டாமன்
சித்திரம் => சித்திரம்
பேசுதடி => பேசுதடி
இசையமைப்பாளரகா => இசையமைப்பாளர
வாள => வாள
மீனுக்கும் => மீனுக்கும்
மக்களிடையே => மக்களிடை
பிரபலமடைந்தது => பிரபலமடை
சம்போ => சம்
சிவ => சிவ
படித்தவர் => படி
ராமணன் => ராமணன்
ஆரவமுதன் => ஆரவமுதன்
வெங்கட => வெங்கட
சப்த => சப்த
ஸ்வரங்கள் => ஸ்வரம்
அறியப்பட்டவராக => அறியப்பட்ட
ராமணனை => ராமண
தொடர்களில் => தொடர்
பொறியயற்பட்டதாரி => பொறியயற்பட்டதாரி
ரமணனின் => ரமணன்
மியூசியானோ => மியூசி
அக்குழுவில் => குழு
ரமணனும் => ரமணன்
நடத்துவர் => நட
ரமணி => ரமணி
மேடைபெயரான => மேடைபெயர்
இல் => இ்
மாம்பலம் => மாம்பலம்
சீனியர்ஸ் => சீனியர்ஸ்
சீனியஸ் => சீனியஸ்
பதிப்பின் => பதி
நடுவர்களிடமிருந்து => நடுவர்களிடம்
ராக்ஸ்டார் => ராக்ஸ்டார்
அறிவரசு => அறிவரசு
கலைநேசன் => கலைநேசன்
பணியாற்றுகின்றார் => பணியாற்று
அனிருத்தின் => அனிரும்
மாசுடர் => மாசுடர்
வாத்தி => வாத்தி
இரைடு => இரைடு
தீஉடன் => தீஉடன்
எஞ்சாய் => சாய்
எஞ்சாமி => சாமி
ஒன்றியம் => ஒன்றியம்
துணைப் => துணை
பாத்திரங்களிலும் => பாத்திரம்
சண்முகசுந்தரியின் => சண்முகசுந்தரி
வெள்ளரிக்கா => வெள்ளரி
பிஞ்சு => பிஞ்சு
வெள்ளரிக்கா => வெள்ளரிக்கா
பொற்காலம் => பொற்காலம்
திரைபடத்தின் => திரைபடம்
மண்ணு => மண்ணு
௭டுத்து => ௭டு
தாமிரபரணி => தாமிரபரணி
தண்ணிய => தண்ணி
விட்டு => விட்டு
திரைபடப் => திரைபட
கலைஞருமாவார் => கலைஞரும்
கோ => கோ
ஆம் => ஆம்
மாதங்களுக்கு => மாதங்கள்
முதலிடத்தைப் => முதலிடம்
தீபக் => தீப
இயக்குனர்களுக்காக => இயக்குனர்கள்
முகமூடி => முகமூடி
வாய => வா
மூடி => மூடி
சும்மா => சும்
இருடா => இருடா
எங்கேயும் => எங்கேய்
எந்தன் => எந்தன்
முன்னே => முன்னே
பாடலும் => பா
கல் => கல்
கண்ணாடி => கண்ணாடி
அகிலா => அ
அகிலா => அகிலா
காதல் => கா
பட்டர்பிளை => பட்டர்பிளை
வந்தான் => வ
வென்றான் => வெல்
அஞ்சனா => அஞ்சன்
அஞ்சனா => சனா
ஐய்யனார் => ஐய்
குத்து => கு
குத்து => குத்து
நெஞ்சோடு => நெஞ்
சேர்த்து => சேர்த்து
மாற்றான் => மா
தீயே => தீ
தீயே => தீயே
கொத்திப் => கொத்தி
பறவை => பறவை
ஜல் => ஜல்
ஜல் => ஜல்
ஓசை => ஓசை
மாயா => ம்
பஜார் => பஜார்
ஆராய்ச்சியாளர் => ஆராய்ச்சியாளர்
காதல் => கா
காம் => காம்
காதல் => காதல்
தனக்கென => தன
அடையாளத்தை => அடையாளம்
பதித்துள்ளார் => பதித்துள்
களிலும்களிலும்பாலசுப்பிரமணியத்தின் => பாலசுப்பிரமணியம்
தயாரிப்பாளராகவும் => தயாரிப்பாளர்
தயாரித்துள்ளார் => தயாரித்துள்
ஆம் => ஆம்
சரோஜாவில் => சரோஜ்
ஹுடுகிகாகியுடன் => ஹுடுகிகாகி
நடித்ததற்காக => நடித்ததல்
ஒர்க்ஸ் => ஒர்க்ஸ்
நிறுவியுள்ளார் => நிறுவியுள்
திரைப்படங்களைத் => திரைப்படம்
தயாரித்தார் => தயாரி
வந்தவரான => வ
வெங்கடநரசிம்மன் => வெங்கடநரசிம்மன்
மதுரம் => மதுரம்
திசம்பரில் => திசம்
ஒ => ஒ
தகவல் => தக
தொழில்நுட்பம் => தொழில்நு
படித்துக்கொண்டிருக்கும் => படி
அகஸ்டின் => அகஸ்
மேக்னா => மே
தாண்டேகர் => தாண்டேகர்
என்பவரிடமிருந்து => என்பவரிடம்
சென்னைக்குச் => சென்
செல்வதற்கு => செல்
கேரளாவில் => கேரள்
புதுமைப்பெண் => புதுமைப்பெண்
இசையமைக்கின்ற => இசையமை
மூவர் => மூ
கூட்டணியின் => கூட்டணி
அங்கமாவார் => கமா
வீச்சிற்காக => வீச்சில்
பெயர்பெற்ற => பெயர்பெற்ற
நடப்பு => நடப்பு
பாடகராகக் => பாடகர்
செம்பூர் => செம்பூர்
கேரளப் => கேரள
இளமையிலேயே => இளமையிலேய்
காலே => காலே
காகா => காகா
என்றழைக்கப்பட்ட => என்றழை
சீனிவாச => சீனிவாச
காலேயிடம் => காலேய்
செம்பூரில் => செம்பூர்
லேடி => லேடி
பெர்பெட்சுவல் => பெர்பெட்சு
சக்கர் => சக்கர்
உயர்நிலைப்பள்ளியில் => உயர்நிலைப்பள்ளி
கற்றபின் => கற்ற
சயான் => சய்
சமூகத்தின் => சமூகம்
இடைநிலைப்பள்ளி => இடைநிலைப்பள்ளி
ஆம் => ஆம்
நவி => நவி
அமைந்துள்ள => அமை
பல்கலைகழகத்தின் => பல்கலைகழகம்
ஆளுமைக்குட்பட்ட => ஆளுமை
ராம்ராவ் => ராம்
அதிக் => அதி
தொழில்நுட்பக் => தொழில்நு
கணிப் => கணி
ஆரக்கிளில் => ஆரக்கிள்
பொறியியலாளராக => பொறியியலாளர்
துவங்கிய => துவங்கி
விரைவிலேயே => விரைவிலேய்
காலடி => காலடி
கண்டுகொண்டேன் => கண்டுகொண்
பிரெத்லெஸ் => பிரெத்லெஸ்
மூச்சின்றி => மூ
இசைத்தொகுப்பின் => இசைத்தொகு
தொடக்கம் => தொடக்கம்
கடைசிவரை => கடைசி
மூச்சிழக்காது => மூச்சிழக்காது
பாடுவது => பாடு
போன்று => போன்று
தொகுக்கப்பட்டிருந்தது => தொகுக்கப்பட்டிரு
சிறப்பாகும் => சிற
அமைக்கத் => அமை
தமிழைத் => தமிழ்
மராத்தியிலும் => மராத்தி
சுசர்லா => சுசர்
சாஸ்திரி => சாஸ்திரி
வாத்தியக் => வாத்தி
இசைத்தட்டுத் => இசைத்தட்டு
திரைப்படங்களுடன் => திரைப்படம்
ஹாலிவூட் => ஹாலிவூ
தாத்தாவான => தா
மும்மூர்த்திகளுள் => மும்மூர்த்தி
தியாகப்பிரம்மம் => தியாகப்பிரம்மம்
சுவாமிகளின் => சுவாமி
சிஷ்ய => சிஷ்
பரம்பரையில் => பரம்பரை
வந்தவராவார் => வ
பெதகல்லேபள்ளி => பெதகல்லேபள்ளி
கிருஷ்ணபிரம்ம => கிருஷ்ணபிரம்ம
ஆசிரியராவார் => ஆசிரியர்
அன்னபூரணம்மா => அன்னபூரணம்
குறைவான => குறை
பாடியிருக்கிறார் => பாடியிர்
தனித்தன்மை => தனித்தன்
வாய்ந்தகுரலால் => வாய்ந்தகுரல்
பெரும்புகழ் => பெரும்புகழ்
திரிச்சூர் => திரிச்சூர்
கடக்காவு => கடக்காவு
சுந்தர => சுந்தர
கெ => கெ
ஜெயராமனிடம் => ஜெயராமன்
மரபிசை => மரபிசை
மெல்லிசைப் => மெல்லிசை
பரிசை => பரிசை
கள்ளிச்செல்லம்மா => கள்ளிச்செல்லம்
அறிமுகம்செய்தார் => அறிமுகம்செய்
மானத்தே => மான
காயலில் => காயல்
இன்னிசைப் => இன்னிசை
பெரும்புகழ்பெற்றார் => பெரும்புகழ்பெ
கனத்த => கன
மென்மையாகப் => மென்மை
பாடக்கூடியவர் => பாடக்கூடி
பாட்டுக்கள் => பாடு
அர்ஜுனன் => அர்ஜு
வாய்ப்புகளை => வாய்ப்பு
கொடுத்தார்கள் => கொடு
இசையுலகின் => இசையுல
பிரம்மானந்தனை => பிரம்
புறக்கணித்தார் => புறக்கணி
ஆகவே => ஆகவே
நேர்ந்தது => நேர்
ஒருகட்டத்தில் => ஒருகட்டம்
வாய்ப்பே => வாய்
இல்லாது => இல்லாது
போயிற்று => போய
இல் => இ்
நாற்பது => நா
தேவாலயக் => தேவால
சுவிசேஷ => சுவிசேஷ
விர்ஜின் => விர்ஜ்
ரெகார்ட்ஸின் => ரெகார்ட்ஸ்
கூட்டு => கூட்டு
விர்ஜின் => விர்ஜ்
சாய்ஸ் => சாய்ஸ்
போட்டியை => போட்டி
இனி => இனி
நானும் => நான்
நானில்லை => நான்
பாடியுளார் => பாடியுள்
அமைப்பாளரும் => அமைப்பாளர்
பாடகியுமாவார் => பாடகியும்
ஒளிபரப்பப்படும் => ஒளிபர
மெய்நிகர் => மெய்நிகர்
நடுவராகவும் => நடு
மராத்தியில் => மராத்தி
ஐகா => ஐகா
தாஜிபா => தாஜிபா
கோம்பாடி => கோம்பாடி
பாலாலி => பாலாலி
நாட் => நா
குலா => குலா
துர்ச்சியா => துர்ச்சி
ரனாத் => ரனாத்
கொம்படி => கொம்
படாலி => படாலி
நிகழ்சிகளிலும் => நிகழ்சி
பாடுமாறு => பாடுமாறு
கேட்டுக்கொள்ளப்படுகிறார் => கேட்டுக்கொள்ள
இராம்நாத் => இர்
வெற்றித் => வெற்றி
வாத்தியக்கலைஞர் => வாத்தியக்கலைஞர்
லால்குடி => லால்குடி
ஜெயராமனின் => ஜெயராமன்
சீடர் => சீடர்
வைத்தது => வை
திரைப்படங்களை => திரைப்படம்
தோன்றத் => தோன்ற
கோடைக்கால => கோடைக்கால
வெற்றியான => வெற்றி
மாறியபோது => மாறியபோ
முதல்முறையாக => முதல்முறை
ஈர்த்தார் => ஈர்
வெற்றிகளைப் => வெற்றி
மங்கத்தா => மங்க
மாஸ் => மாஸ்
மசிலாமணி => மசிலாமணி
அரசியல்வாதியும் => அரசியல்வாதி
இயக்கியும் => இயக்கி
வேடங்களைக் => வேடம்
நடிப்பிற்காக => நடிப்பில்
நட்சத்திரம் => நட்சத்திரம்
தயாரிப்பாளராக => தயாரிப்பாளர்
விருதுகள்கள் => விருதுகள்
உள்ளடங்கலாக => உள்ளடங்கல்
பிறமொழிப்படத்திற்கான => பிறமொழிப்படத்தில்
இந்தியாவிலிருந்து => தியாவில்
பரிந்துரைக்கப்பட்ட => பரிந்துரை
அதிகமானவற்றிலும் => அதிகம்
மட்டுமல்லாது => மட்டுமல்லாது
திரைக்கதையாசிரியர் => திரைக்கதையாசிரியர்
பன்முகத்தன்மை => பன்முகத்தன்
விளங்குகின்றார் => விளம்
திரைத்துறைக்கு => திரைத்துறை
ஆற்றிய => ஆற்றி
சத்தியபாமா => சத்தி
கமல்ஹாசனிற்கு => கமல்ஹாசனி
ஆண்டுகளை => ஆண்டு
நிறைவுசெய்த => நிறைவுசெய்
மிகச்சிலரில் => மிகச்சிலர்
ஒருவரானார் => ஒரு
திரைத்துறை => திரைத்துறை
வாழ்க்கையானது => வாழ்க்கை
ஆரம்பித்தது => ஆரம்பி
நடித்தற்காக => நடித்தல்
ஜனாதிபதி => ஜனாதிபதி
இயக்குநரைச் => இயக்குநர்
சந்திப்பார் => சந்தி
திருத்தங்களைச் => திருத்தம்
திரைபடங்களில் => திரைபடம்
நடண => நடண
தங்கப்பன் => தங்க
அவர்களிடம் => அவர்
பாலசந்தரின் => பாலசந்தர்
அரங்கேற்றம் => அரங்கேற்றம்
வாலிப => வாலி
கன்னியாகுமரி => கன்னியாகுமரி
படமே => படமே
திரைப்படமாகும் => திரைப்படம்
இத்திரைப்படதிற்காக => திரைப்படதில்
வது => வ
அபூர்வ => அபூர்
முக்கியக் => முக்கி
தமிழுக்கான => தமிழ்
தேவர் => தே
தசாவதாரம் => தசாவதாரம்
ராஜ்கமல் => ராஜ்கம்
இன்டர்நேசனல் => இன்டர்நேசன்
நிறுவனத்தையும் => நிறு
காதல்திரைப்பட => காதல்திரைப்பட
இயக்குநரான => இயக்குநர்
ஏன் => ஏன்
மயக்கினாய் => மயக்கினாய்
பாடப் => பாட
வெளிவந்ததே => வெளி
வெற்றிபெற்ற => வெற்றிபெற்ற
சம்திங் => சம்திம்
இசையமைத்ததின் => இசையமை
அண் => அண்
காளிதாசில் => காளி
நடித்தவர் => நடி
தெலுங்கைத் => தெலும்
சின்னப்பாவுடன் => சின்
தென்னிந்திய => தென்னிந்தி
சைகால் => சைகால்
பாராட்டப் => பாராட்ட
மாரடைப்பால் => மாரடை
என்னமோ => என்
ஏதோ => ஏதோ
வாய => வா
இருடா => இருடா
எங்கேயும் => எங்கேய்
எந்தன் => எந்தன்
முன்னே => முன்னே
அகிலா => அ
அகிலா => அகிலா
பட்டர்பிளை => பட்டர்பிளை
அஞ்சனா => அஞ்சன்
அஞ்சனா => சனா
குத்து => கு
குத்து => குத்து
நெஞ்சோடு => நெஞ்
சேர்த்து => சேர்த்து
தீயே => தீ
தீயே => தீயே
ஜல் => ஜல்
ஓசை => ஓசை
மாயா => ம்
பஜார் => பஜார்
சாரங் => சாரங்
நெஞ்சோடு => நெஞ்
சேர்த்து => சேர்த்து
ஷாஜி => ஷாஜி
கருண் => கருண்
குட்டிஸ்ராங்க் => குட்டிஸ்
திரைபபடத்தில் => திரைபபடம்
மழவில் => மழ
மங்கோ => மங்
பிளவர்ஸ் => பிளவர்ஸ்
ஆம் => ஆம்
புன்யா => புன்
செல்வாவுடன் => செல்
மெய் => மெய்
வது => வது
பிடித்தார் => பிடி
பிடித்ததற்காக => பிடித்ததல்
புட்டா => புடு
பதிப்புகள் => பதிப்பு
பாடுவதற்கான => பாடுவதல்
உயிரே => உயிர்
தய்யா => தய்
நாடோடித் => நாடோடி
தென்றல் => தெல்
பிரியாமணியின் => பிரியாமணி
உறவினர் => உறவி
பிண்ணனி => பிண்ணனி
பாடலகளைப் => பாடல
அழகே => அழ
அழகே => அழகே
அழகிய => அழகி
வளையப்பட்டி => வளையப்பட்டி
தவிலே => தவிலே
கனா => கனா
கானும் => கான்
காலங்கள் => காலங்கள்
வேலாயுதம் => வேலாயுதம்
ரத்தத்தின் => ரத்தம்
ரததமே => ரததமே
போன்வை => போன்
பரணி => பரணி
தொடரான => தொடர்
ராஜகீதத்தில் => ராஜகீதம்
குரல் => குரல்
வெளிப்பட்டார் => வெளி
சுஜாதாவால் => சுஜா
இவராவார் => இவரா
மில்லியனரின் => மில்லி
இடம்பெற்றுள்ளார் => இடம்பெற்றுள்
ஹிந்தி => ஹிந்தி
நேபாளம் => நேபாளம்
இருபத்தைந்து => இருபத்தை
ஆகக்கூடுதலான => ஆகக்கூடுதல்
மதிப்பையும் => மதி
ஜோதிகா => ஜோதி
தோன்றிய => தோன்றி
இதயம் => இதயம்
எண்ணெய் => எண்ணெய்
விளம்பரத்திற்கான => விளம்பரத்தில்
சிறுபாடலைப் => சிறுபாடல்
பதிவுசெய்து => பதிவுசெய்
நுழைவுச்சீட்டு => நுழைவுச்சீட்டு
விவரிக்கிறார் => விவரி
இசைத்த => இசை
அமைந்துள்ளன => அமைந்துள்ள
க்கும்இசைத்தென்றல் => இசைத்தெல்
ல் => ்
தீன் => தீன்
பாடிப் => பாடி
வின்சன்ட் => வின்சன்
ஏற்பாட்டாளர் => ஏற்பாட்டாளர்
ரவிச்சந்தர் => ரவிச்சந்தர்
சூர்யா => சூர்
ஜோஷ்வா => ஜோஷ்
ஸ்ரீதர் => ஸ்ரீதர்
வணக்கம் => வணக்கம்
ஹே => ஹே
மரியான் => மரி
நெடுஞ்சாலை => நெடுஞ்சால்
டாலர் => டாலர்
ஆர்ம் => ஆர்
யாமிருக்க => யாமிர்
பயமேன் => பயம்
இடம்பெற்றுள்ளது => இடம்பெற்றுள்ள
ஏர்டெல் => ஏர்டெல்
சிங்கர் => சிங்கர்
மனோரமாவின் => மனோரம்
ஜோஸ்கோ => ஜோஸ்
ஆஸ்ட்ரோ => ஆஸ்
சூப்பர் => சூ
ஸ்டார் => ஸ்டார்
செய்யவும் => செய்
தயாரிக்கவும் => தயாரி
ஃபெ => ஃபெ
ஈடுபடுகிறார் => ஈடு
லோகநாதனின் => லோகநாதன்
கில்லாடி => கில்லாடி
ஹோத்தா => ஹோ
ஹய் => ஹய்
ஜென்டில்மன் => ஜென்டில்மன்
காதலன் => காதலன்
ஜீன்ஸ் => ஜீன்ஸ்
ஹவுஸ் => ஹவுஸ்
வாக்கேயக்காரர் => வாக்கேயக்காரர்
குணசித்திர => குணசித்திர
திறப்பட்ட => திற
மொழிகள் => மொழி
திறமையுடன் => திறம்
கேரளாவிலுள்ள => கேரள்
தேர்ச்சிப் => தேர்ச்சி
கலோனியல் => கலோனி
கசினிஸ் => கசினிஸ்
குழுவின் => குழு
உறுப்பினர் => உறுப்பி
லெஸ்லி => லெஸ்லி
லூயிசும் => லூயி
ஹரிஹரனும் => ஹரிஹரன்
தொகுப்புகளை => தொகுப்பு
வெளியிட்டுள்ளது => வெளியிட்டுள்ள
ல் => ்
மோதி => மோதி
தமிழ்ப்படத்திற்குப் => தமிழ்ப்படத்தி
அமைத்துள்ளது => அமைத்துள்ள
சுசரித்ரா => சுசரி
ரீடா => ரீடா
போன்றவர்களின் => போன்ற
இந்தியிலும் => தி
திரைப்பாடல்கள் => திரைப்பாடல்
வேதியியல் => வேதியி
பத்தாண்டுகள் => பத்தாண்டு
உட்புகுந்து => உட்புகு
படைத்தவர் => படை
அம்பாசமுத்திரத்தில் => பாசமுத்திரம்
துரைசாமி => துரைசாமி
இலட்சுமிக்கு => இலட்சுமி
அத்தை => தை
உந்துதலில் => துதல்
நாட்டமும் => நாட்டம்
பட்டப்படிப்பினை => பட்டப்படி
கீழுள்ள => கீழ்
தொழில்நுட்பத் => தொழில்நு
துறை => துறை
பொறியாளராகப் => பொறியாளர்
பணிபுரிந்தபிறகு => பணிபுரிந்தபிறகு
இசையார்வம் => இசையார்வம்
பணிவாழ்வில் => பணிவாழ்
மாற்றத்தை => மாற்றம்
இளையராஜாவிடம் => இளையராஜ்
பணிபுரிய => பணிபுரி
கிடைத்தும் => கிடை
அன்றைய => அல்
தொண்டைப்புண் => தொண்டைப்புண்
நிறைவேறவில்லை => நிறைவேற
இசையமைப்பாளினி => இசையமைப்பாளினி
சகோதரியும் => சகோதரி
பவானி => பவானி
தாயுமாவார் => தாயும்
மாதேஷ் => மாதேஷ்
மல்லே => மல்
தேவாவின் => தேவா
தயாளுடன் => தய்
பல்லேலக்கா => பல்லேல
வாழ்கையில் => வாழ்கை
சில்க்ஸ் => சில்க்ஸ்
சுகுணா => சுகுண்
மோட்டார்கள் => மோடு
டஸ்லர் => டஸ்லர்
நைல் => நைல்
பாலிஸ் => பாலிஸ்
நிறுவனங்களுக்கு => நிறுவனங்கள்
ஜிங்கில்ஸை => ஜிங்கில்ஸ்
அமைத்திருக்கிறார் => அமைத்திர்
ரையின்ட்ராப்ஸ் => ரையின்ட்ராப்ஸ்
நல்லெண்ணத் => நல்லெண்ண
தூதராக => தூதர்
இருக்கின்றார் => இர்
பிரீத்தம் => பிரீத்தம்
இசையமைப்பாளருக்கு => இசையமைப்பாளர்
உதவியாளராகப் => உதவியாளர்
பேம் => பேம்
குருகுல் => குருகுல்
பிரபலமடைந்து => பிரபலமடை
பாடகரானார் => பாடகர்
நிகழ்ச்சிகளுக்கான => நிகழ்ச்சிகள்
புகழடைந்தார் => புகழடை
இல் => இ்
ஆஷிக் => ஆஷி
ஹி => ஹி
பெருத்த => பெரு
புகழைச் => புகழ்
வங்காளத்தின் => வங்காளம்
முர்ஷிதாபாத்தில் => முர்ஷி
ஜியாகஞ்சில் => ஜியாகஞ்
கக்கர் => கக்கர்
சீக்கியரும் => சீக்கியர்
பெங்காலியரும் => பெங்காலியர்
அத்தையிடம் => தை
பிஜய் => பிஜய்
சிறிபத் => சிறி
ராஜேந்திர => ராஜேந்திர
ஹசாரியிடம் => ஹசாரி
சங்கீத் => சங்கி
ரவீந்திரநாத் => ரவீந்திர
என்பவற்றை => என்ப
திரேந்திர => திரேந்திர
ஹசாரி => ஹசாரி
சகோதரர்களிடம் => சகோதரர்
பெறுவதற்காக => பெறுவதல்
அரசாங்க => அர
உதவித்தொகை => உதவித்தொகை
தெறி => தெறி
பென்சில் => பென்
கபாலி => கபாலி
ஜிகர்தண்டா => ஜிகர்தண்
பாடலாசிரியராக => பாடலாசிரியர்
அனைவரின் => அனை
கராத்தே => கரா
நெருப்பு => நெருப்பு
நானூறுக்கும் => நானூ
தெலுங்கிலும் => தெலும்
சுசித்ரா => சுசி
கோயம்புத்தூரில் => கோயம்புத்தூர்
புனேயில் => புனேய்
எப்போதாவது => போதா
எழுதுகிறார் => எழுது
நெப்போலியன் => நெப்போலியன்
வாசித்த => வாசி
சூரசம்ஹாரம் => சூரசம்ஹாரம்
நீயல்லவோ => நீ
தேவ => தேவ
பாடியிருந்தாலும் => பாடியிரு
பாடியதே => பாடி
அப்பாடல்கள் => பாடல்
வரவேற்பையும் => வரவே
ஸ்தோத்திர => ஸ்தோத்திர
சட்டம்பிகல்யாணிக்காக => சட்டம்பிகல்யாணி
கும்பலத்தில் => கும்பலம்
கொச்சியின் => கொச்சி
சேக்ரட் => சேக்ர
ஹார்ட் => ஹார்
தேவராவில் => தே
தாவரவியலில் => தாவரவியல்
படவுலகில் => படவுல
ஓமனகுட்டி => ஓமனகுட்டி
மியூசிக்ஸ் => மியூசிக்ஸ்
பூஜப்புராவில் => பூஜப்புர்
சரிகம => சரிகம
டிகேஎஸ் => டிகேஎஸ்
தமிழகத் => தமிழ
தெம்மாங்கு => தெம்
நாடகத்துறையில் => நாடகத்துறை
சிறுவனாக => சிறு
அடைமொழியோடு => அடைமொழி
சின்னபொண்ணு => சின்னபொண்ணு
கிராமம் => கிராமம்
முதலே => மு
கோயில்களிலும் => கோயில்
தேவாலயங்களிலும் => தேவாலயம்
பாடத்துவங்கிய => பாடத்துவங்கி
கோட்டைச்சாமி => கோட்டைச்சாமி
குழுவினருடன் => குழுவி
பாடத்துவங்கினார் => பாடத்துவங்கி
ஆய்வியலாளர் => ஆய்வியலாளர்
குணசேகரனின் => குணசேகரன்
மேடைகள் => மேடை
பலவற்றிலும் => பலவ
சின்னப்பொண்ணுவின் => சின்னப்பொண்ணு
ஒலிக்கச் => ஒலி
செய்தது => செய்
இரஜினிகாந்த் => இரஜினி
வாழ்த்துறேன் => வாழ்
அடியெடுத்து => அடியெடு
வைத்த => வை
காதலில் => காதல்
விழுந்தேன் => விழு
நாக்கு => நா
முக்கா => ம்
புகழ்பெற்றது => புகழ்பெற்ற
கைலேஷ் => கைலேஷ்
கெர் => கெர்
மலேசியப் => மலேசி
மலேசியாவின் => மலேசி
பினாங்கு => பின்
ஒப்பிடப்படும் => ஒப்பிட
இசையமப்பாளர்களான => இசையமப்பாளர்கள்
இளையராஜாவுக்கும் => இளையராஜா
ரகுமானுக்கும் => ர
ரசிகராவார் => ரசிகர்
பயணத்தை => பயணம்
வாயிலாகத் => வாயில்
வர்மனின் => வர்மன்
கனவெல்லாம் => கனவ
நீதானே => நீ
பெற்றதாகும் => பெற்ற
இவன்தான் => இவன்
ஆண்டிற்கான => ஆண்டில்
அமைச்சர் => அமைச்சர்
டத்தோ => ட
சாமிவேலுவும் => சாமிவேலு
கனவுகள் => கனவு
வரும் => வரும்
பாடல்தொகுப்பிற்கு => பாடல்தொகுப்பி
ஆண்டில்தான் => ஆண்டில்
அங்கீகரிக்கப்பட்டது => கீகரி
எனலாம் => எனல்
நவீனம் => நவீனம்
பாடல்தொகுப்பில் => பாடல்தொகு
பெற்றர் => பெற்றர்
உயிரைத் => உயிர்
தொட்டேன் => தொட்டேன்
காரணமாகவும் => காரணம்
தரத்தினாலும் => தரம்
டி => டி
ஹெச் => ஹெ
ராகா => ராகா
மலேசியன் => மலேசியன்
டாப் => டா
நீண்ட => நீண்ட
நாட்களாக => நாட்கள்
ஒலிபரப்பப்பட்டது => ஒலிபர
கனவெல்லாம் => கனவெல்லாம்
இசைக்கோவைக்குப் => இசைக்கோ
மீண்டும் => மீண்
மீண்டும் => மீண்டும்
இசைக்கோவையைத் => இசைக்கோ
இசைக்கோவையை => இசைக்கோ
பாடகருடன் => பாடகர்
நடிப்பதிலும் => நடி
காட்டி => காட்டி
இரசினிகாந்தின் => இரசினி
ஆசிரமத்தின் => ஆசிரமம்
தலைவராகவும் => தலை
இயங்கிவரும் => இயங்கி
பள்ளிக்குத் => பள்ளி
இவை => இவை
தவிர் => தவிர்
மகள்களுக்குச் => மகள்கள்
சொந்தமான => சொந்தம்
ஆச்சேர் => ஆச்சேர்
ஸ்டுடியோஸ் => ஸ்டுடியோஸ்
நிகழ்த்து => நிகழ்
நிகழ்ச்சியாளர் => நிகழ்ச்சியாளர்
நிகழ்த்துகிறார் => நிகழ்
பிளேயர் => பிளேயர்
ராஜூவுடன் => ராஜூ
ராமச்சந்திரன் => ராமச்சந்திரன்
எக்ஸெலன்ஸின் => ஸெலன்ஸ்
போர்த்துகீசியம் => போர்த்துகீசியம்
ரோமானிய => ரோமானி
மொழியிலும் => மொழி
ஃபனாஎன்ற => ஃபனாஎன்ற
யுவா => யுவா
புரிகிறார் => புரி
மாணவியாக => மாணவி
இருக்கும்போதே => இருக்கும்போ
கைரளி => கைரளி
சிம்பொனி => சிம்பொனி
மாசிலாமணி => மாசிலாமணி
டோரா => டோர்
டோரா => டோரா
பக் => ப
பக் => பக்
மாடப்புறா => மாடப்புறா
வெட்டோத்தி => வெட்டோத்தி
கொலைகாரா => கொலை
அனலாச்சு => அனலாச்சு
படத்தின் => படத்தின்
குண்டு => குண்டு
பிரகாசமான => பிரகாசம்
எதிர்காலம் => எதிர்காலம்
கொண்டதாக => கொண்ட
முன்னெழுத்துகளாலும் => முன்னெழு
அதிகமாகப் => அதிகம்
பாடும் => பா
நிலா => நிலா
தேசியத் => தேசி
சாதனைகள் => சாத
புத்தகத்தில் => புத்தகம்
பிடித்துள்ளார் => பிடித்துள்
திரைத்துறைப் => திரைத்துறை
ஆளுமைக்கான => ஆளுமை
வழங்கிச் => வழங்கி
சிறப்பித்தது => சிறப்பி
கோவிடு => கோ
தொற்றினால் => தொ
பாதிக்கப்பட்டுக் => பாதி
ஆஸ்திரேலிய => ஆஸ்திரேலி
ஆண்டுகளுக்கு => ஆண்டுகள்
குறைந்தது => குறை
சோப்ராவின் => சோ
மனோஜ் => மனோஜ்
இல் => இ்
ஆம் => ஆம்
இதய => இதய
நோய் => நோய்
உன்னிமேனன் => உன்னிமே
திரைப்பாடல்களை => திரைப்பாடல்
துவக்கத்தில் => துவக்கம்
அறியப்படாத => அறி
உன்னிமேனனுக்கு => உன்னிமே
ஆம் => ஆம்
ரோஜாத் => ரோஜா
புது => புது
வெள்ளை => வெள்
மழை => மழை
உன்னி => உன்னி
குருவாயூரில் => குருவாயூர்
குருவாயூரிலும் => குருவாயூர்
பாலக்காட்டிலும் => பாலக்காடு
கற்று => கற்று
பாலக்காட்டின் => பாலக்காடு
விக்டோரியா => விக்டோரி
இயல்பியலில் => இயல்பியல்
இளமையில் => இளமை
பெருநாட்டம் => பெருநாட்டம்
காட்டிய => காட்டி
படிக்கும்போதே => படிக்கும்போ
சுண்டலிக்கும் => சுண்டலி
கல்யாணமாம் => கல்யாணம்
கைதி => கைதி
கண்ணாயிரம் => கண்ணாயிரம்
சிட்டுக் => சிடு
சிட்டுக்குருவி => சிட்டுக்குரு
சேதி => சேதி
தெரியுமா => தெரி
டவுன் => டவுன்
பஸ் => பஸ்
குழந்தைத்தனமான => குழந்தை
கமலஹாசன் => கமலஹாசன்
வாழ்வைத் => வாழ்
அம்மாவும் => மா
நீயே => நீயே
அப்பாவும் => பா
குழந்தைப்பாடல் => குழந்தை
கூரப்படுகிறது => கூர
இராசேச்வரி => இராசேச்வரி
இல் => இ்
திரையுலக => திரையுல
வாழ்வை => வாழ்
ஏஎம் => ஏஎம்
இராஜா => இராஜ்
பாலசுப்பிரமணியன் => பாலசுப்பிரமணியன்
ஆளுமை => ஆளும்
ராஜஸ்தானிய => ராஜஸ்தானி
தனித்துவமான => தனித்துவம்
ஹஸ்கி => ஹஸ்கி
தனித்துவத்தை => தனித்துவம்
அளிக்கிறது => அளி
இஷிதா => இஷி
லாமே => லாமே
ஜோதா => ஜோதா
அக்பர் => பர்
ஷாடி => ஷாடி
சைட் => சை
எஃபெக்ட்ஸ் => எஃபெக்ட்ஸ்
தோன்றியுள்ளார் => தோன்றியுள்
சுருதிஹாசன் => சுருதிஹாசன்
துறைகளில் => துறை
வெளிப்படுத்தி => வெளிப்படுத்தி
சரிகா => சரி
ஒருவன் => ஒரு
கண்ணாலே => கண்
கண்ணாலே => கண்ணாலே
தொகுப்பு => தொகுப்பு
தரவரிசையில் => தரவரிசை
கண்ணாலை => கண்ணால்
காதலே => கா
காதலே => காதலே
பாடல்களுக்காவும் => பாடல்கள்
பரேஷானுரா => பரேஷானுரா
சூசா => சூ
சூசா => சூசா
சாலி => சாலி
காலி => காலி
சூடுடு => சூடுடு
காந்தாரி => காந்தாரி
யாரோ => யாரோ
பாடங்களுக்காக => பாடங்கள்
கொடுப்பவரும் => கொடு
க்கும்குழந்தைகளுக்கு => குழந்தைகள்
கள்ளிப்பால் => கள்ளி
கொடுத்து => கொடு
கொல்கிறார் => கொல்
கதாப்பாத்திரத்தின் => கதாப்பாத்திரம்
சடுகுடு => சடுகுடு
குஞ்சரமாளுடன் => குஞ்சரம்
நடித்தர் => நடித்தர்
தாஜ்மகால் => தாஜ்ம
விருமாண்டி => விருமாண்டி
அருள் => அர்
ரூபாரூ => ரூபாரூ
மயிலிறகே => மயிலிறகே
ரங் => ரம்
பசந்தி => பசந்தி
இசையமைப்பாளராவார் => இசையமைப்பாளர்
பின்பற்றுபவர் => பின்பற்று
இந்திமொழித் => திமொழி
விருதுகளான => விருதுகள்
பூசணும் => பூசண்
வழங்கப்பட்டன => வழங்கப்பட்ட
சகோதரிக்கும் => சகோதரி
மகனுக்கும் => மகன்
கொடுத்தவர் => கொடு
குடியரசு => குடியரசு
நாட்டுப்பற்றுப் => நாட்டுப்பற்று
வழங்குனராகவும் => வழம்
அறியப்படுகின்றார் => அறி
வழங்குனர் => வழம்
விசாலம் => விசாலம்
எட்டாயிரத்திற்கும் => எட்டாயிரம்
வானொலிப் => வானொலி
பராசக்தி => பராசக்தி
இரத்தக்கண்ணீர் => இரத்தக்கண்
சீமை => சீமை
கேரளத்தைச் => கேரளம்
மாமன்னரின் => மாமன்
தலைநகராகத் => தலைநகர்
திருப்புனித்துறையில் => திருப்புனித்துறை
அகாடமியில் => அகாடமி
தூர்தர்சனில் => தூர்தர்சன்
தரபடுத்தப்பட்ட => தர
யுள்ளார் => யுள்
திவ்யா => தி
வேகப்பந்து => வேக
வீச்சாளர் => வீச்சாளர்
ஸ்ரீசாந்த் => ஸ்ரீ
தமையனாவார் => தமையன்
சந்திரமனா => சந்திரமன்
நாரயணன் => நாரயணன்
நம்பூதிரியிடம் => நம்பூதிரி
துவக்கிய => துவக்கி
கிருஷ்ணசாமி => கிருஷ்ணசாமி
வேதவல்லி => வேதவல்லி
மேற்பயிற்சி => மேற்பயிற்சி
மன்மத => மன்ம
ராசா => ராசா
இராகவன் => இராக
இராஜம் => இராஜம்
பிரம்மா => பிரம்
நளினா => நள்
லெட்சுமண => லெட்சுமண
பாகவதரின் => பாகவதர்
அய்யம்பேட்டையில் => யம்பேட்டை
சுதர்ஸன் => சுதர்ஸன்
கண்ணனாக => கண்ணன்
விஜயகுமாரி => விஜயகுமாரி
கமலாவுக்காக => கமலா
எங்கிருந்தாலும் => கிரு
வாழ்க => வாழ்
சீட்டுக்கட்டு => சீட்டுக்கட்டு
என்ன => என்ன
வேகம் => வேகம்
நில்லு => நில்லு
அங்கமுத்து => கமு
தங்கமுத்து => தங்கமு
அறியப்பட்டவர் => அறியப்பட்ட
நாடோடி => நாடோடி
திரைப்பாடலுக்கு => திரைப்பாடல்
ஆடினார் => ஆடி
பிற்காலத்தில் => பிற்காலம்
அலைகள் => அலை
அகல்யா => அகல்
அனுமதிக்கப்பட்டதில் => அனுமதிக்கப்பட்ட
கொரோனா => கொரோன்
வைரசு => வைரசு
கண்டறியப்பட்டது => கண்டறி
கோஷல் => கோஷ்
தேவ்தாஸ் => தேவ்தாஸ்
உலகுக்கு => உல
திரைவாழ்வை => திரைவாழ்
சின்னத் => சின்
ஸ்ரீபதா => ஸ்ரீ
சண்டக்கோழி => சண்டக்கோழி
போட்டியைத் => போட்டி
ஒளிபரப்பாகும் => ஒளிபர
ஆஹா => ஆஹா
பண்பலையில் => பண்பலை
திங்கள் => திங்
சனிக்கிழமை => சனிக்கிழம்
க்ளப் => க்ள
தொகுப்பாளினியாகவும் => தொகுப்பாளினி
தருபவராகவும் => தருப
பூமிகா => பூமி
சாவ்லாவிற்கு => சாவ்லாவி
உன்னாலே => உன்
தனிஷா => தனிஷ்
முகெர்ஜிக்கு => முகெர்ஜி
சத்தம் => சத்தம்
போடாதே => போடா
பத்மபிரியாவிற்கு => பத்மபிரியாவி
தாம் => தாம்
கங்கனா => கங்கன்
ரனாத்திற்கு => ரனாத்தி
கொண்டான் => கொண்
லேகா => லேகா
வாஷிங்டனிற்கு => வாஷிங்டனி
சக்கரகட்டி => சக்கரகட்டி
வேதிகாவிற்கு => வேதிகாவி
சமீரா => சம்
ரெட்டிக்கு => ரெட்டி
கதாபாத்திரங்களுக்கு => கதாபாத்திரங்கள்
தந்துள்ளார் => தந்துள்
சிம்ரன் => சிம்ரன்
கீர்த்தனாவின் => கீர்த்தன்
இசையமைப்பிலேயே => இசையமைப்பிலேய்
தேரே => தேரே
பினா => பினா
மையா => மையா
பதினேழாவது => பதினேழ்
ஆம் => ஆம்
அரங்கேற்ற => அரங்கேற்ற
படையப்பாவில் => படை
வெற்றிக் => வெற்றி
கொடி => கொடி
கட்டு => கட்டு
மில்லியனரில் => மில்லி
லிக்விட் => லிக்
டேன்ஸ்சும் => டேன்ஸ்
பட்டம்மாள் => பட்டம்
பட்டம்மாளின் => பட்டம்
சிவகுமார் => சிவகு
சிவகுமாரின் => சிவகு
நித்யஸ்ரீயின் => நித்யஸ்ரீ
மகளாகிய => ம
லாவண்யா => லாவண்
சுந்தரராமன் => சுந்தரராமன்
வளர்ந்துவரும் => வளர்
நீண்டகாலமாக => நீண்டகாலம்
இருந்துள்ளார் => இருந்துள்
எந்திரன் => திரன்
முதல்வன் => முதல்
வகித்துள்ளார் => வகித்துள்
நகாப் => நகா
ஏக் => ஏக்
தெரி => தெரி
கலர்ஸ் => கலர்ஸ்
உசைன் => உசைன்
இளம்வயது => இளம்
கவ்வாலி => கவ்வாலி
வல்லவரான => வல்ல
தன்னைக் => தன்
கீர்த்தனைகள் => கீர்
கூறிதாக => கூறி
பேட்டியின் => பேட்டி
அலியின் => அலி
குரலைக் => குரல்
இவன் => இவன்
வருவான் => வரு
நன்றி => நன்றி
தெரிவிக்கும் => தெரி
வாமணன் => வாமணன்
செய்கிறாய் => செய்
குங்கும => குங்கும
பூவும் => பூ
கொஞ்சும் => கொஞ்
புறாவும் => புறா
சின்னஞ் => சின்னஞ்
சிறுசுக => சிறுசு
சர்வம் => சர்வம்
சிறகுகள் => சிறகு
பேச்சாளரும் => பேச்சாளர்
வம்சா => வம்
வழியில் => வழி
நாட்டவராவார் => நாட்ட
காசுமீரத்தைச் => காசுமீரம்
பாடிவருகிறார் => பாடிவரு
ஹம்மா => ஹம்
சாங் => சாங்
ஓகே => ஓகே
ஜானு => ஜானு
பிர் => பிர்
தும்கோ => தும்
சாஹுன்கா => சாஹுன்கா
பாரிஷ் => பாரிஷ்
ஹால்ஃப் => ஹால்ஃ
கேர்ள்பிரெண்டு => கேர்ள்பிரெண்டு
கன்ஹா => கன்ஹா
சோனா => சோனா
லியே => லியே
சல் => சல்
கஹின் => கஹ்
டோர் => டோர்
கசூ => கசூ
கிளபம் => கிள
கருவிகளையும் => கரு
கூடியவர் => கூடி
வான் => வ்
உல்க்கா => உல்
மயூர் => மயூர்
கிளவுட் => கிளவுட்
இந் => இந்
நாடகத்தின் => நாடகம்
பூரி => பூரி
போர்த்துகீசிய => போர்த்துகீசி
பருவத்திலும் => பருவம்
உலகத்தில் => உலகம்
வாழ்ந்ததால் => வாழ்
கலாச்சாரங்களையும் => கலாச்சாரம்
பாணிகளையும் => பாணி
இணைத்தார் => இணை
இவரதுஆங்கில => இவரதுஆங்கில
இசைப்பாடல்கள் => இசைப்பாடல்
பிரதிபலிக்கும் => பிரதிபலி
பிரெஞ்சு => பிரெஞ்சு
போர்த்துக்கேயம் => போர்த்துக்கேயம்
துணைப்பாடகராக => துணைப்பாடகர்
இசையமைப்பாளர்களும் => இசையமைப்பாளர்
விரும்பும் => விரும்
எனக்கொரு => எனக்கொரு
கெர்ல்பிரண்ட் => கெர்ல்பிரண்
வேணுமடா => வேணுமடா
கஜினியில் => கஜினி
மாலை => மாலை
கண்டன => கண்ட
கொத்தபங்காரு => கொத்தபங்காரு
லோகம் => லோகம்
ஹாப்பிடேஸ் => ஹாப்பிடேஸ்
அவ => அவ
என்ன => என்ன
பெற்றுள்ளது => பெற்றுள்ள
கஜினி => கஜினி
பெக்கா => பெக்கா
மோகனின் => மோகன்
